,twitter_username,tweets_count,postive,negative,sum_sentiment,postive_r,negative_r
1,SKinnock,2617,927,1690,-720.400000000002,0.3542223920519679,0.6457776079480321
2,CenLD,2798,942,1856,-831.600000000001,0.33666904932094355,0.6633309506790565
3,sadievidal,22,12,10,1.5999999999999996,0.5454545454545454,0.45454545454545453
4,GutoAberconwy,335,122,213,-85.60000000000002,0.3641791044776119,0.6358208955223881
5,Emily4Aberconwy,698,264,434,-158.19999999999985,0.37822349570200575,0.6217765042979942
6,isobeldavidson,335,104,231,-124.59999999999992,0.31044776119402984,0.6895522388059702
7,Grace_E_OKeeffe,183,62,121,-51.99999999999999,0.33879781420765026,0.6612021857923497
8,OrrVinegoldLab,11,8,3,5.199999999999999,0.7272727272727273,0.2727272727272727
9,callumjodwyer,2593,713,1880,-1094.3999999999987,0.27497107597377557,0.7250289240262244
10,RossThomson_MP,2943,1176,1767,-547.0000000000006,0.399592252803262,0.6004077471967381
11,wilsjen,843,243,600,-325.20000000000044,0.28825622775800713,0.7117437722419929
12,AirdrieShottsLP,250,65,185,-113.79999999999997,0.26,0.74
13,LeoDochertyUK,375,141,234,-86.19999999999997,0.376,0.624
14,alanhilliar,1,1,0,1.0,1.0,0.0
15,Gary_Puffett,2903,946,1957,-923.2000000000018,0.32586978987254567,0.6741302101274543
16,JohnFisher_1,284,96,188,-86.99999999999996,0.3380281690140845,0.6619718309859155
17,ablibdems,1,0,1,-0.8,0.0,1.0
18,morton_wendy,496,199,297,-89.2,0.4012096774193548,0.5987903225806451
19,JaneBrophyLD,2347,766,1581,-755.6000000000024,0.3263740945888368,0.6736259054111632
20,AndrewHWestern,696,234,462,-215.60000000000005,0.33620689655172414,0.6637931034482759
21,lauraknightly,147,53,94,-39.4,0.36054421768707484,0.6394557823129252
22,MarkTamiMP,891,308,583,-237.1999999999998,0.345679012345679,0.654320987654321
23,CllrJamesDawson,2372,723,1649,-841.4000000000015,0.3048060708263069,0.695193929173693
24,KateSmithLibDem,2,1,1,0.0,0.5,0.5
25,Campbell4Angus,132,24,108,-77.39999999999996,0.18181818181818182,0.8181818181818182
26,Kirstene4Angus,355,136,219,-80.99999999999999,0.38309859154929576,0.6169014084507042
27,CliveSneddon,338,85,253,-160.39999999999995,0.2514792899408284,0.7485207100591716
28,marygwengriff,782,236,546,-283.00000000000006,0.30179028132992325,0.6982097186700768
29,AlanReidAandB,11,3,8,-4.3999999999999995,0.2727272727272727,0.7272727272727273
30,LabourASD,543,139,404,-257.2,0.2559852670349908,0.7440147329650092
31,nickherbertmp,1165,487,678,-169.99999999999952,0.41802575107296136,0.5819742489270386
32,TonyHar57558301,5,2,3,-0.40000000000000013,0.4,0.6
33,GloriaDePiero,2694,937,1757,-731.0000000000027,0.3478099480326652,0.6521900519673348
34,sanng7,166,45,121,-68.99999999999997,0.2710843373493976,0.7289156626506024
35,DamianGreen,1409,560,849,-265.7999999999996,0.397444996451384,0.602555003548616
36,cm_hicks,431,145,286,-127.59999999999992,0.33642691415313225,0.6635730858468677
37,jackmrankin,1681,551,1130,-545.6000000000012,0.3277810826888757,0.6722189173111244
38,AngelaRayner,2253,807,1446,-580.2000000000013,0.3581890812250333,0.6418109187749668
39,stevenlambert1,20,4,16,-11.399999999999999,0.2,0.8
40,DLidington,2545,1103,1442,-288.60000000000105,0.43339882121807466,0.5666011787819254
41,CMochan,1981,684,1297,-570.4000000000012,0.3452801615345785,0.6547198384654215
42,VictoriaPrentis,854,355,499,-131.99999999999997,0.41569086651053866,0.5843091334894613
43,SEANLWOODCOCK,2628,727,1901,-1104.6000000000004,0.2766362252663623,0.7233637747336378
44,margarethodge,606,207,399,-177.59999999999997,0.3415841584158416,0.6584158415841584
45,DanJarvisMP,1561,610,951,-306.2000000000003,0.39077514413837283,0.6092248558616271
46,DavidRidgway67,651,192,459,-248.99999999999994,0.29493087557603687,0.7050691244239631
47,Steph_Peacock,576,149,427,-250.39999999999978,0.2586805555555556,0.7413194444444444
48,NicolaJTurner,159,46,113,-60.200000000000024,0.2893081761006289,0.710691823899371
49,LoraineBirchall,272,101,171,-63.599999999999994,0.3713235294117647,0.6286764705882353
50,simonfell,1132,349,783,-395.00000000000045,0.3083038869257951,0.691696113074205
51,CllrBlock,2,0,2,-1.6,0.0,1.0
52,AEuropeanBrit,1822,647,1175,-502.60000000000093,0.35510428100987923,0.6448957189901208
53,JohnShawLibDem,7,1,6,-4.4,0.14285714285714285,0.8571428571428571
54,LD4Bassetlaw,453,148,305,-153.99999999999986,0.32671081677704195,0.673289183222958
55,JohnMannMP,1844,602,1242,-592.0000000000005,0.3264642082429501,0.6735357917570499
56,Wera_Hobhouse,1653,525,1128,-522.6000000000017,0.3176043557168784,0.6823956442831216
57,benhowlettuk,2897,989,1908,-847.2000000000014,0.34138764238867797,0.6586123576113221
58,joerayment91,701,191,510,-295.8000000000005,0.2724679029957204,0.7275320970042796
59,AnnMyatt2015,39,17,22,-3.0,0.4358974358974359,0.5641025641025641
60,Marshadecordova,1296,417,879,-408.400000000001,0.32175925925925924,0.6782407407407407
61,DrDickyD,595,152,443,-277.1999999999998,0.25546218487394956,0.7445378151260504
62,JaneEllison,1329,591,738,-119.99999999999973,0.44469525959367945,0.5553047404063205
63,_jamesenglish,44,8,36,-26.6,0.18181818181818182,0.8181818181818182
64,LabourMarina,910,315,595,-234.79999999999984,0.34615384615384615,0.6538461538461539
65,JulieIreland,523,188,335,-131.99999999999991,0.35946462715105165,0.6405353728489483
66,BedfordVann,1813,606,1207,-550.4000000000012,0.3342526199669057,0.6657473800330943
67,Siobhan_Baillie,791,297,494,-169.79999999999978,0.3754740834386852,0.6245259165613148
68,coyleneil,2869,1012,1857,-759.0000000000013,0.35273614499825723,0.6472638550017428
69,SimonHughes,2207,862,1345,-429.80000000000103,0.39057544177616677,0.6094245582238332
70,ScottDickinson0,546,178,368,-183.19999999999985,0.326007326007326,0.673992673992674
71,annietrev,2757,1112,1645,-476.80000000000103,0.40333696046427275,0.5966630395357272
72,VoteCarolineB,105,34,71,-36.199999999999996,0.3238095238095238,0.6761904761904762
73,John2Win,1178,445,733,-277.4000000000001,0.3777589134125637,0.6222410865874364
74,rushanaraali,1537,591,946,-309.80000000000047,0.3845152895250488,0.6154847104749512
75,WilliamPHDyer,535,126,409,-267.6,0.23551401869158878,0.7644859813084112
76,JohannaBoal,133,43,90,-45.000000000000014,0.3233082706766917,0.6766917293233082
77,grahamstuart,553,222,331,-96.39999999999992,0.4014466546112116,0.5985533453887885
78,Bayliss4BB,213,36,177,-130.39999999999995,0.16901408450704225,0.8309859154929577
79,jpkemp94,757,252,505,-237.5999999999999,0.332892998678996,0.667107001321004
80,HuwMerriman,865,370,495,-123.60000000000007,0.4277456647398844,0.5722543352601156
81,StefBorella,2163,615,1548,-885.6000000000017,0.2843273231622746,0.7156726768377254
82,DavidEvennett,604,217,387,-166.79999999999998,0.35927152317880795,0.640728476821192
83,SimRey14,2351,667,1684,-949.0000000000022,0.2837090599744789,0.7162909400255211
84,AllanBrame,472,149,323,-159.19999999999993,0.3156779661016949,0.684322033898305
85,frankfieldteam,573,193,380,-170.5999999999999,0.3368237347294939,0.6631762652705061
86,ColinGreenLD,830,245,585,-316.2000000000001,0.29518072289156627,0.7048192771084337
87,JackDromeyMP,2149,947,1202,-222.19999999999985,0.4406700791065612,0.5593299208934388
88,Jerry4MP,151,49,102,-48.2,0.32450331125827814,0.6754966887417219
89,RogerGodsiff,133,25,108,-79.79999999999998,0.18796992481203006,0.8120300751879699
90,Reena_Ranger,258,97,161,-55.40000000000001,0.375968992248062,0.624031007751938
91,PhilBennionMEP,1,0,1,-0.6,0.0,1.0
92,LiamByrneMP,2305,821,1484,-582.0000000000025,0.3561822125813449,0.6438177874186551
93,ar_browning,17,7,10,-3.0000000000000004,0.4117647058823529,0.5882352941176471
94,leedargue,2287,747,1540,-737.4000000000003,0.32662877131613466,0.6733712286838653
95,ShabanaMahmood,821,292,529,-211.19999999999982,0.3556638246041413,0.6443361753958587
96,RichardBurdenMP,2983,1020,1963,-882.4000000000016,0.34193764666443177,0.6580623533355682
97,rogerbhx,1272,334,938,-569.6000000000008,0.26257861635220126,0.7374213836477987
98,ch4pb,840,368,472,-90.99999999999993,0.4380952380952381,0.5619047619047619
99,khalid4PB,1781,588,1193,-561.6000000000006,0.33015160022459294,0.6698483997754071
100,steve_mccabe,2194,668,1526,-793.4000000000015,0.30446672743846853,0.6955332725615314
101,radclifd,121,28,93,-60.40000000000001,0.23140495867768596,0.768595041322314
102,Sophie4SellyOak,26,8,18,-9.200000000000001,0.3076923076923077,0.6923076923076923
103,manchester453,38,18,20,-2.5999999999999996,0.47368421052631576,0.5263157894736842
104,johnhemming4mp,1803,365,1438,-1025.4000000000008,0.20244037714919577,0.7975596228508042
105,jessphillips,1365,363,1002,-606.400000000001,0.26593406593406593,0.734065934065934
106,C_F_Adams,145,40,105,-60.400000000000006,0.27586206896551724,0.7241379310344828
107,HelenGoodmanMP,3055,1006,2049,-957.8000000000021,0.3292962356792144,0.6707037643207856
108,mozdog94,831,206,625,-397.00000000000045,0.24789410348977137,0.7521058965102286
109,IrfanAhmedUK,27,9,18,-9.4,0.3333333333333333,0.6666666666666666
110,Bobrjeastwood,518,191,327,-117.5999999999999,0.3687258687258687,0.6312741312741312
111,Kate_HollernMP,906,314,592,-262.3999999999998,0.3465783664459161,0.6534216335540839
112,davidgoss,43,18,25,-5.3999999999999995,0.4186046511627907,0.5813953488372093
113,PaulMaynardUK,540,190,350,-151.39999999999998,0.35185185185185186,0.6481481481481481
114,Chris4BNC,1297,462,835,-347.4000000000003,0.3562066306861989,0.643793369313801
115,peterfor2017,98,32,66,-27.60000000000002,0.32653061224489793,0.673469387755102
116,GordonMarsden,2838,1140,1698,-489.0000000000019,0.40169133192389006,0.5983086680761099
117,traceymwest,12,5,7,-2.0,0.4166666666666667,0.5833333333333334
118,Tom_Smith26,293,126,167,-32.20000000000001,0.4300341296928328,0.5699658703071673
119,BVLabour,118,38,80,-31.000000000000007,0.3220338983050847,0.6779661016949152
120,atbutcher,1455,186,1269,-788.8000000000104,0.12783505154639174,0.8721649484536083
121,NickGibbUK,620,248,372,-111.19999999999996,0.4,0.6
122,helenharrisonuk,946,396,550,-132.19999999999982,0.4186046511627907,0.5813953488372093
123,RossShippy,1184,395,789,-380.4000000000001,0.33361486486486486,0.6663851351351351
124,DavidCrausby,925,293,632,-318.8000000000002,0.31675675675675674,0.6832432432432433
125,cllrjamesdaly,684,356,328,33.799999999999976,0.52046783625731,0.47953216374269003
126,WarrenLFox,807,196,611,-374.4000000000008,0.24287484510532836,0.7571251548946716
127,VoteSarahPochin,215,84,131,-41.20000000000001,0.39069767441860465,0.6093023255813953
128,YasminQureshiMP,1147,453,694,-219.19999999999985,0.3949433304272014,0.6050566695727986
129,fozziebecs,1584,444,1140,-653.8000000000004,0.2803030303030303,0.7196969696969697
130,CGreenUK,2244,845,1399,-506.6000000000013,0.37655971479500894,0.6234402852049911
131,Peter_Dowd,1448,487,961,-443.4000000000007,0.3363259668508287,0.6636740331491713
132,charlesfifield,2253,779,1474,-659.0000000000006,0.3457612072791833,0.6542387927208166
133,paul_r_kenny,1881,553,1328,-707.8000000000025,0.29399255715045186,0.7060074428495481
134,mattwarman,2864,820,2044,-1126.0000000000014,0.28631284916201116,0.7136871508379888
135,_ChrisKealey,1592,559,1033,-418.6000000000013,0.35113065326633164,0.6488693467336684
136,miketmullaney,2472,840,1632,-740.400000000001,0.33980582524271846,0.6601941747572816
137,Tobias_Ellwood,1039,507,532,-40.99999999999998,0.4879692011549567,0.5120307988450433
138,ConorBurnsUK,779,306,473,-154.7999999999999,0.392811296534018,0.6071887034659821
139,LibDemPhil,482,149,333,-169.00000000000003,0.3091286307053942,0.6908713692946058
140,dave4bmthwest,120,47,73,-22.60000000000001,0.39166666666666666,0.6083333333333333
141,PaulforMP,1168,408,760,-328.7999999999999,0.3493150684931507,0.6506849315068494
142,DrPhillipLeeMP,427,206,221,-18.0,0.48243559718969553,0.5175644028103045
143,PatrickSmithLD,227,81,146,-59.6,0.3568281938325991,0.6431718061674009
144,Imran_HussainMP,1001,356,645,-262.40000000000003,0.35564435564435565,0.6443556443556444
145,mgjewellLD,273,87,186,-94.59999999999998,0.31868131868131866,0.6813186813186813
146,JudithCummins,1126,457,669,-195.59999999999982,0.4058614564831261,0.5941385435168739
147,GeorgePBGrant,1296,452,844,-364.6000000000005,0.3487654320987654,0.6512345679012346
148,NazShahBfd,2706,982,1724,-673.4000000000028,0.36289726533628974,0.6371027346637103
149,JamesCleverly,2654,865,1789,-867.8000000000005,0.325923134890731,0.674076865109269
150,MalcolmFincken,2003,583,1420,-762.2000000000019,0.291063404892661,0.708936595107339
151,BtreeWithamLibs,271,73,198,-115.79999999999997,0.2693726937269373,0.7306273062730627
152,JamesGibsonWatt,66,14,52,-25.20000000000001,0.21212121212121213,0.7878787878787878
153,DanLodge,225,77,148,-62.40000000000001,0.3422222222222222,0.6577777777777778
154,RahoulBhansali,1287,462,825,-329.80000000000047,0.358974358974359,0.6410256410256411
155,DawnButlerBrent,2483,924,1559,-562.2000000000022,0.3721304873137334,0.6278695126862666
156,anton_georgiou,2434,788,1646,-798.0000000000013,0.323746918652424,0.676253081347576
157,BarryGardiner,1722,558,1164,-544.8000000000012,0.3240418118466899,0.6759581881533101
158,Ameet_Jogia,458,173,285,-97.59999999999992,0.3777292576419214,0.6222707423580786
159,JosephBourke,206,51,155,-93.39999999999993,0.24757281553398058,0.7524271844660194
160,RuthCadbury,2962,955,2007,-954.4000000000007,0.3224172856178258,0.6775827143821742
161,MaryMacleodUK,872,436,436,8.199999999999966,0.5,0.5
162,GarethPBarrett,332,79,253,-164.00000000000003,0.23795180722891565,0.7620481927710844
163,alexburghart,660,266,394,-109.59999999999995,0.403030303030303,0.5969696969696969
164,LDKatz71,1876,545,1331,-727.0000000000005,0.2905117270788913,0.7094882729211087
165,MadeleineMoon,1017,380,637,-238.5999999999998,0.37364798426745327,0.6263520157325467
166,weshinckes,1027,90,937,-578.8000000000073,0.08763388510223953,0.9123661148977604
167,MarcusKravis,86,23,63,-38.0,0.26744186046511625,0.7325581395348837
168,JerryLonsdale1,610,169,441,-252.79999999999998,0.27704918032786885,0.7229508196721312
169,TerenceSmith14,1174,351,823,-436.80000000000086,0.2989778534923339,0.7010221465076661
170,EmilyTesterLD,345,91,254,-154.2,0.263768115942029,0.736231884057971
171,EmmaWarman,2159,849,1310,-420.0000000000004,0.39323761000463175,0.6067623899953682
172,theodoraclarke,1348,671,677,14.799999999999958,0.4977744807121662,0.5022255192878339
173,KerryMP,2961,775,2186,-1305.7999999999952,0.2617359000337724,0.7382640999662277
174,CeliaBristol,476,181,295,-99.79999999999988,0.3802521008403361,0.6197478991596639
175,darrenpjones,544,182,362,-170.59999999999982,0.33455882352941174,0.6654411764705882
176,CharlotteLeslie,2135,852,1283,-383.20000000000067,0.3990632318501171,0.600936768149883
177,BenNutland,389,150,239,-79.39999999999995,0.3856041131105398,0.6143958868894601
178,karinsmyth,3053,1071,1982,-840.2000000000012,0.35080248935473307,0.649197510645267
179,ThangamMP,2632,747,1885,-1084.3999999999996,0.2838145896656535,0.7161854103343465
180,annabeltall,133,54,79,-18.999999999999996,0.40601503759398494,0.5939849624060151
181,swilliamsmp,3067,1016,2051,-959.4000000000017,0.33126834039778286,0.6687316596022171
182,IainSimpson,1323,438,885,-408.20000000000084,0.3310657596371882,0.6689342403628118
183,sarakhyde,2763,1044,1719,-571.6000000000028,0.3778501628664495,0.6221498371335505
184,neill_bob,2248,911,1337,-377.00000000000125,0.4052491103202847,0.5947508896797153
185,samdwebber,2164,709,1455,-682.6000000000009,0.327634011090573,0.672365988909427
186,sajidjavid,1759,737,1022,-246.19999999999993,0.4189880613985219,0.5810119386014782
187,Neil_Lewis,2800,864,1936,-989.6000000000018,0.30857142857142855,0.6914285714285714
188,mthompson_dr,373,91,282,-181.79999999999995,0.24396782841823056,0.7560321715817694
189,andyg2439,238,31,207,-173.2,0.13025210084033614,0.8697478991596639
190,NorgroveSelina,10,3,7,-3.2,0.3,0.7
191,Tim_Hallam,460,155,305,-135.5999999999999,0.33695652173913043,0.6630434782608695
192,Anna_Soubry,2915,820,2095,-1164.3999999999958,0.28130360205831906,0.7186963979416809
193,GBirtwistle,17,5,12,-6.6,0.29411764705882354,0.7058823529411765
194,JulieForBurnley,1072,335,737,-376.60000000000065,0.3125,0.6875
195,CllrPaulWhite,1664,501,1163,-609.800000000001,0.3010817307692308,0.6989182692307693
196,AndrewGriffiths,2136,741,1395,-608.200000000001,0.34691011235955055,0.6530898876404494
197,DominicHardwick,103,26,77,-48.0,0.2524271844660194,0.7475728155339806
198,jamckier,63,22,41,-18.200000000000003,0.3492063492063492,0.6507936507936508
199,richardbaum,2199,719,1480,-698.8000000000018,0.3269668030923147,0.6730331969076853
200,BuryNorthLabour,576,191,385,-173.3999999999998,0.3315972222222222,0.6684027777777778
201,DNuttall,290,122,168,-45.000000000000014,0.4206896551724138,0.5793103448275863
202,IvanLewis_MP,1486,692,794,-77.19999999999979,0.46567967698519513,0.5343203230148048
203,andrew4bury,318,111,207,-89.39999999999996,0.3490566037735849,0.6509433962264151
204,Jochurchill4,782,324,458,-129.39999999999998,0.4143222506393862,0.5856777493606138
205,hkorfanty,29,14,15,-1.6,0.4827586206896552,0.5172413793103449
206,SWEValleys,537,137,400,-236.39999999999972,0.25512104283054005,0.74487895716946
207,WayneDavid_MP,1586,647,939,-265.4,0.40794451450189156,0.5920554854981085
208,Jane4MCC,1597,613,984,-338.40000000000083,0.38384470882905447,0.6161552911709455
209,Invernessbelle,1447,524,923,-360.2000000000007,0.3621285418106427,0.6378714581893573
210,struanmackie,1308,427,881,-424.4000000000005,0.3264525993883792,0.6735474006116208
211,JamieHWStone,6,2,4,-1.8,0.3333333333333333,0.6666666666666666
212,BattyeJanet,532,185,347,-148.39999999999992,0.34774436090225563,0.6522556390977443
213,JoshFG,1915,560,1355,-733.2000000000002,0.2924281984334204,0.7075718015665796
214,HarrietHarman,1850,626,1224,-515.8000000000018,0.33837837837837836,0.6616216216216216
215,DrBenSpencer,126,49,77,-27.2,0.3888888888888889,0.6111111111111112
216,geoff4mp,2,0,2,-2.0,0.0,1.0
217,DrJohnHayward,494,181,313,-119.59999999999988,0.36639676113360325,0.6336032388663968
218,julianhuppert,2433,793,1640,-769.6000000000013,0.3259350595972051,0.6740649404027949
219,DanielZeichner,2483,944,1539,-530.0000000000017,0.3801852597664116,0.6198147402335884
220,Dadgey,562,123,439,-297.0,0.2188612099644128,0.7811387900355872
221,NGreen4libdems,277,89,188,-88.59999999999998,0.3212996389891697,0.6787003610108303
222,amandamilling,791,257,534,-266.00000000000045,0.324905183312263,0.6750948166877371
223,RosieDuffield1,2690,905,1785,-792.8000000000017,0.33643122676579923,0.6635687732342007
224,JamesCanterbury,759,300,459,-138.3999999999998,0.3952569169960474,0.6047430830039525
225,Eluned_Parrott,1819,586,1233,-586.0000000000007,0.32215503023639364,0.6778449697636064
226,JoStevensLabour,1903,687,1216,-470.0000000000016,0.36100893326326855,0.6389910667367315
227,AnnaMcMorrin,594,248,346,-92.8,0.4175084175084175,0.5824915824915825
228,Craig_William5_,3153,1248,1905,-565.4000000000027,0.39581351094196005,0.60418648905804
229,billvrees,135,48,87,-36.0,0.35555555555555557,0.6444444444444445
230,KevinBrennanMP,2722,939,1783,-761.6000000000004,0.3449669360764144,0.6550330639235856
231,alexmeredithLD,2102,642,1460,-750.2000000000019,0.3054234062797336,0.6945765937202664
232,MattSmithWales,2461,1072,1389,-279.19999999999965,0.4355952864689151,0.5644047135310849
233,ruthalcroft,76,29,47,-16.2,0.3815789473684211,0.618421052631579
234,John4Carlisle,344,128,216,-75.99999999999993,0.37209302325581395,0.627906976744186
235,PeterThornton10,2169,637,1532,-795.0000000000023,0.29368372521899494,0.7063162747810051
236,TurkRocker,42,21,21,-0.1999999999999995,0.5,0.5
237,Havard_Hughes,3139,1065,2074,-909.600000000002,0.33928002548582353,0.6607199745141765
238,AlistairTewkes,8,1,7,-6.0,0.125,0.875
239,Simonhartmp,730,222,508,-267.2,0.3041095890410959,0.6958904109589041
240,MarcTierney2017,698,225,473,-228.79999999999987,0.3223495702005731,0.6776504297994269
241,thomasbrake,2934,998,1936,-869.6000000000016,0.3401499659168371,0.6598500340831629
242,Emina_ibrahim,1358,386,972,-556.4000000000007,0.28424153166421207,0.7157584683357879
243,mmaxwellscott,1352,385,967,-522.8000000000012,0.28476331360946744,0.7152366863905325
244,JoeCookeLabour,190,66,124,-55.99999999999999,0.3473684210526316,0.6526315789473685
245,RebeccaHarrisMP,2739,1023,1716,-641.0000000000017,0.37349397590361444,0.6265060240963856
246,tomholder,2920,776,2144,-1290.799999999995,0.26575342465753427,0.7342465753424657
247,tominglis,9,4,5,-0.6,0.4444444444444444,0.5555555555555556
248,NairnMcD,2411,786,1625,-802.8000000000014,0.32600580671920365,0.6739941932807963
249,alexjwhiteld,250,93,157,-58.60000000000001,0.372,0.628
250,drdanpoulter,1667,623,1044,-377.2000000000007,0.3737252549490102,0.6262747450509898
251,AidanVdeW,2579,784,1795,-937.8000000000026,0.30399379604497867,0.6960062039550213
252,Ruth_R_Davis,385,152,233,-73.19999999999999,0.3948051948051948,0.6051948051948052
253,CeredigionLab,2664,842,1822,-892.0000000000023,0.3160660660660661,0.683933933933934
254,mark4ceredigion,1107,468,639,-155.5999999999999,0.42276422764227645,0.5772357723577236
255,seankellywalsh,993,336,657,-296.0000000000001,0.338368580060423,0.6616314199395771
256,tracey_crouch,1972,650,1322,-609.8000000000018,0.32961460446247465,0.6703853955375254
257,vincemaple,1965,677,1288,-561.0000000000016,0.344529262086514,0.655470737913486
258,MarkHunter,406,132,274,-135.60000000000005,0.3251231527093596,0.6748768472906403
259,cheadlelabour,1608,533,1075,-500.60000000000093,0.3314676616915423,0.6685323383084577
260,MaryRobinson01,261,114,147,-33.4,0.4367816091954023,0.5632183908045977
261,vickyford,2430,941,1489,-509.4000000000006,0.38724279835390946,0.6127572016460905
262,sj_robinson,433,138,295,-146.99999999999994,0.3187066974595843,0.6812933025404158
263,ChrisJVince,1244,427,817,-360.20000000000056,0.3432475884244373,0.6567524115755627
264,AlanDeAth1,311,127,184,-52.19999999999998,0.40836012861736337,0.5916398713826366
265,GregHands,2532,1030,1502,-430.0000000000012,0.4067930489731438,0.5932069510268563
266,Louise_Rowntree,1708,575,1133,-508.20000000000135,0.3366510538641686,0.6633489461358314
267,AlexChalkChelt,132,47,85,-30.40000000000001,0.3560606060606061,0.6439393939393939
268,MartinChelt,1849,607,1242,-580.0000000000015,0.32828555976203355,0.6717144402379664
269,CheltKeithLab,48,8,40,-31.2,0.16666666666666666,0.8333333333333334
270,CheshamAmersham,785,260,525,-241.19999999999973,0.33121019108280253,0.6687898089171974
271,CherylGillan,2459,962,1497,-476.2000000000011,0.3912159414396096,0.6087840585603904
272,tobyperkinsmp,2558,851,1707,-783.4000000000016,0.3326817826426896,0.6673182173573105
273,SpencerPitfield,2952,1254,1698,-391.00000000000034,0.4247967479674797,0.5752032520325203
274,ChesterfieldLD,147,41,106,-54.80000000000002,0.2789115646258503,0.7210884353741497
275,LibIntervention,2599,921,1678,-706.2000000000012,0.35436706425548287,0.6456329357445171
276,ChiLabour_15,3013,939,2074,-1046.8000000000045,0.31164951875207436,0.6883504812479256
277,GillianKeegan,585,265,320,-41.6,0.452991452991453,0.5470085470085471
278,bilal_labour,715,241,474,-211.59999999999982,0.33706293706293705,0.6629370629370629
279,DebWiseUnger,1814,611,1203,-544.2000000000012,0.3368246968026461,0.663175303197354
280,HelenCBelcher,2856,800,2056,-1158.599999999999,0.2801120448179272,0.7198879551820728
281,michelledonelan,1661,619,1042,-379.80000000000047,0.37266706803130645,0.6273329319686936
282,AndyD_Newman,1291,403,888,-470.0000000000003,0.31216111541440744,0.6878388845855926
283,EmmaWhysall,856,248,608,-337.4000000000001,0.2897196261682243,0.7102803738317757
284,stephenjohnfenn,3,0,3,-3.0,0.0,1.0
285,LindsayHoyle_MP,868,367,501,-121.8,0.4228110599078341,0.5771889400921659
286,cllrmoon,1466,634,832,-171.7999999999998,0.4324693042291951,0.567530695770805
287,Patsindorset,1261,417,844,-400.00000000000074,0.33068992862807295,0.669310071371927
288,mikefcox,54,24,30,-6.200000000000001,0.4444444444444444,0.5555555555555556
289,ibrahim_Dogus,2466,827,1639,-674.2000000000048,0.3353609083536091,0.6646390916463909
290,MarkFieldUK,244,96,148,-43.20000000000003,0.39344262295081966,0.6065573770491803
291,BridgetFox,2653,906,1747,-762.2000000000013,0.3415001884658877,0.6584998115341123
292,elizabethjewkes,80,29,51,-17.200000000000006,0.3625,0.6375
293,ChrisM4Chester,407,104,303,-193.8,0.25552825552825553,0.7444717444717445
294,robertabwMP,4471,1761,2710,-863.6000000000015,0.3938716170878998,0.6061283829121002
295,DisgruntledRad,1533,493,1040,-504.8000000000014,0.32159165035877363,0.6784083496412263
296,GilesWatling,298,135,163,-24.0,0.45302013422818793,0.5469798657718121
297,roy_horobin,297,103,194,-83.19999999999997,0.3468013468013468,0.6531986531986532
298,MrPeterKeith,110,24,86,-55.2,0.21818181818181817,0.7818181818181819
299,MartinVickers,43,20,23,-4.200000000000001,0.46511627906976744,0.5348837209302325
300,baynes_simon,2070,919,1151,-184.59999999999997,0.4439613526570048,0.5560386473429951
301,susanelanjones,801,317,484,-151.39999999999995,0.39575530586766544,0.6042446941323346
302,WxmBruce,777,237,540,-279.4000000000001,0.305019305019305,0.694980694980695
303,gareththomaslab,1451,506,945,-403.60000000000053,0.3487250172294969,0.6512749827705031
304,hgaffney48,34,9,25,-15.0,0.2647058823529412,0.7352941176470589
305,willquince,689,185,504,-295.5999999999999,0.26850507982583455,0.7314949201741655
306,Tim4Labour,2485,926,1559,-570.6000000000021,0.372635814889336,0.6273641851106639
307,CahalBurke,1164,400,764,-348.00000000000017,0.3436426116838488,0.6563573883161512
308,JasonMcCartney,2761,1168,1593,-360.40000000000055,0.4230351321984788,0.5769648678015212
309,Thelma_WalkerMP,2531,933,1598,-600.0000000000019,0.36862900039510077,0.6313709996048993
310,Sam4Congleton,100,36,64,-22.4,0.36,0.64
311,DrHirst4Congltn,99,25,74,-45.2,0.25252525252525254,0.7474747474747475
312,hanson4copeland,108,20,88,-62.60000000000001,0.18518518518518517,0.8148148148148148
313,CopelandTories,142,58,84,-24.000000000000007,0.4084507042253521,0.5915492957746479
314,GillTroughton,2539,819,1720,-834.4000000000024,0.322567940133911,0.677432059866089
315,BethMiller91,241,71,170,-86.59999999999992,0.2946058091286307,0.7053941908713693
316,VotePursglove,1271,514,757,-206.4,0.4044059795436664,0.5955940204563336
317,Corbychris,1467,378,1089,-672.8000000000009,0.25766871165644173,0.7423312883435583
318,TJMayer1,2732,872,1860,-880.8000000000026,0.3191800878477306,0.6808199121522694
319,ReshamKotecha,1669,596,1073,-425.20000000000095,0.35710005991611743,0.6428999400838825
320,Geoffrey4CovNW,144,52,92,-35.99999999999999,0.3611111111111111,0.6388888888888888
321,gregjudge,384,123,261,-124.1999999999999,0.3203125,0.6796875
322,MichelleLowe14,2644,981,1663,-614.6000000000014,0.3710287443267776,0.6289712556732224
323,Tim4Crawley,245,65,180,-102.79999999999987,0.2653061224489796,0.7346938775510204
324,MarkoScepy,219,81,138,-54.00000000000004,0.3698630136986301,0.6301369863013698
325,HenrySmithUK,2891,1187,1704,-481.6000000000014,0.4105845728121757,0.5894154271878242
326,CreweLabour,235,84,151,-61.40000000000002,0.3574468085106383,0.6425531914893617
327,GavinBarwell,2815,882,1933,-952.4000000000012,0.3133214920071048,0.6866785079928952
328,GhillyFlower,2703,935,1768,-753.4000000000021,0.34591194968553457,0.6540880503144654
329,LabourSJ,692,246,446,-180.9999999999998,0.3554913294797688,0.6445086705202312
330,samuelkasumu,354,148,206,-49.99999999999999,0.4180790960451977,0.5819209039548022
331,JenniferBrathwa,975,298,677,-345.2000000000006,0.30564102564102563,0.6943589743589743
332,CroydonLibDems,160,58,102,-41.40000000000001,0.3625,0.6375
333,CPhilpOfficial,1505,440,1065,-586.0000000000007,0.292358803986711,0.707641196013289
334,AnnClwyd,752,261,491,-208.99999999999997,0.3470744680851064,0.6529255319148937
335,Nicola_Knight1,1460,567,893,-286.0000000000003,0.38835616438356163,0.6116438356164383
336,JonCruddas_1,423,161,262,-97.0,0.3806146572104019,0.6193853427895981
337,jonathanfryer,2722,1057,1665,-567.6000000000048,0.38831741366642175,0.6116825863335783
338,JulieMarson,2977,1129,1848,-667.0000000000031,0.3792408464897548,0.6207591535102452
339,JennyChapman,2265,703,1562,-776.2000000000013,0.31037527593818987,0.6896247240618102
340,curryannemarie,62,16,46,-28.000000000000004,0.25806451612903225,0.7419354838709677
341,pmcuthbertson,351,102,249,-137.19999999999993,0.2905982905982906,0.7094017094017094
342,Simon_Beard,109,19,90,-65.19999999999999,0.1743119266055046,0.8256880733944955
343,chhcalling,1668,538,1130,-546.600000000001,0.3225419664268585,0.6774580335731415
344,ASJSimpson,567,176,391,-198.19999999999987,0.31040564373897706,0.689594356261023
345,DavidHansonMP,2599,825,1774,-894.8000000000008,0.3174297806848788,0.6825702193151212
346,LouiseAnkersLD,398,96,302,-191.19999999999993,0.24120603015075376,0.7587939698492462
347,GwynneMP,1832,611,1221,-542.600000000002,0.3335152838427948,0.6664847161572053
348,Lucycare,2787,925,1862,-877.6000000000022,0.33189809831359884,0.6681019016864012
349,DerbyChrisW,713,209,504,-270.1999999999999,0.29312762973352036,0.7068723702664796
350,joenaitta,383,78,305,-216.39999999999992,0.20365535248041775,0.7963446475195822
351,EvonneWilliams,11,4,7,-2.8,0.36363636363636365,0.6363636363636364
352,Roobotham,490,151,339,-171.39999999999984,0.3081632653061224,0.6918367346938775
353,AndyHollyer,188,63,125,-57.20000000000001,0.3351063829787234,0.6648936170212766
354,Patrick4Dales,220,86,134,-40.60000000000001,0.39090909090909093,0.6090909090909091
355,chrisfordevizes,105,31,74,-37.400000000000006,0.29523809523809524,0.7047619047619048
356,devizeslabour,2422,779,1643,-789.8000000000009,0.3216350123864575,0.6783649876135426
357,PrescottBeth,2745,1152,1593,-379.6000000000017,0.419672131147541,0.580327868852459
358,paulasherriff,2627,921,1706,-715.2000000000018,0.3505900266463647,0.6494099733536354
359,AaronBell80,484,148,336,-168.59999999999985,0.30578512396694213,0.6942148760330579
360,CarolineFlintMP,2863,948,1915,-886.8000000000008,0.3311212015368495,0.6688787984631506
361,ajsmith_libdem,39,13,26,-12.799999999999999,0.3333333333333333,0.6666666666666666
362,cllrtomhunt1,979,377,602,-211.99999999999972,0.38508682328907046,0.6149131767109295
363,RobertLibDem,592,117,475,-241.79999999999876,0.19763513513513514,0.8023648648648649
364,Ed_Miliband,430,164,266,-92.39999999999989,0.3813953488372093,0.6186046511627907
365,CharlieElphicke,1533,764,769,13.000000000000066,0.4983692106979778,0.5016307893020222
366,IanAustinMP,2993,937,2056,-1019.2000000000016,0.31306381556966256,0.6869361844303374
367,i_benjicus,189,67,122,-48.60000000000002,0.3544973544973545,0.6455026455026455
368,CouncillorLes,880,277,603,-296.0000000000002,0.31477272727272726,0.6852272727272727
369,JonBramall,840,250,590,-315.4000000000001,0.2976190476190476,0.7023809523809523
370,natashamillward,1977,587,1390,-740.0000000000005,0.296914516944866,0.7030854830551341
371,mikejwood,878,258,620,-331.40000000000015,0.2938496583143508,0.7061503416856492
372,helenhayes_,2840,1019,1821,-718.6000000000004,0.3588028169014085,0.6411971830985915
373,libdemgail,269,96,173,-73.19999999999999,0.35687732342007433,0.6431226765799256
374,racheljanetwolf,31,11,20,-7.400000000000002,0.3548387096774194,0.6451612903225806
375,JohnFerry18,1627,601,1026,-396.20000000000056,0.3693915181315304,0.6306084818684696
376,DavidMundellDCT,656,290,366,-67.8,0.4420731707317073,0.5579268292682927
377,LesleyBzz,2591,922,1669,-698.0000000000005,0.35584716325742954,0.6441528367425704
378,price_eleanor,11,4,7,-2.8,0.36363636363636365,0.6363636363636364
379,CowanDundeeWest,12,5,7,-2.4000000000000004,0.4166666666666667,0.5833333333333334
380,jCalderLibDem,405,149,256,-101.19999999999996,0.36790123456790125,0.6320987654320988
381,norman_mathew,281,88,193,-99.19999999999996,0.31316725978647686,0.6868327402135231
382,JonBall,2803,825,1978,-1048.8,0.2943275062433107,0.7056724937566893
383,RupaHuq,2615,875,1740,-793.2000000000019,0.33460803059273425,0.6653919694072657
384,joymorrissey,2794,1091,1703,-540.0000000000018,0.3904795991410165,0.6095204008589835
385,isogrant,2170,781,1389,-570.6000000000008,0.3599078341013825,0.6400921658986175
386,humairasanders,60,23,37,-11.0,0.38333333333333336,0.6166666666666667
387,NigelBakhai,9,3,6,-2.8000000000000003,0.3333333333333333,0.6666666666666666
388,fabio_conti88,205,76,129,-52.400000000000006,0.37073170731707317,0.6292682926829268
389,VirendraSharma,1493,538,955,-387.80000000000007,0.3603482920294709,0.6396517079705292
390,TD_Hancock,230,60,170,-101.39999999999995,0.2608695652173913,0.7391304347826086
391,grahamemorris,2351,755,1596,-769.800000000001,0.32113994045087196,0.678860059549128
392,HugoSwire,1297,551,746,-171.19999999999976,0.4248265227447957,0.5751734772552043
393,Callum4EastDun,101,47,54,-6.600000000000002,0.46534653465346537,0.5346534653465347
394,sheilamechan,434,140,294,-140.59999999999997,0.3225806451612903,0.6774193548387096
395,joswinson,2487,873,1614,-668.8000000000014,0.35102533172496986,0.6489746682750301
396,stephenctimms,2276,834,1442,-524.4000000000029,0.3664323374340949,0.6335676625659051
397,InclusionQuery,73,12,61,-47.00000000000001,0.1643835616438356,0.8356164383561644
398,rkdasgupta,1430,491,939,-410.8000000000009,0.34335664335664334,0.6566433566433566
399,DamianHinds,446,188,258,-62.199999999999996,0.42152466367713004,0.57847533632287
400,RRobinsonLD,1409,512,897,-360.6000000000003,0.3633782824698368,0.6366217175301633
401,monique2017GE,76,21,55,-30.400000000000013,0.27631578947368424,0.7236842105263158
402,PaulMcGarryUK,719,238,481,-237.2,0.33101529902642557,0.6689847009735744
403,lizstclairlegge,116,47,69,-21.0,0.4051724137931034,0.5948275862068966
404,MartWhitfieldMP,1532,589,943,-325.40000000000043,0.38446475195822455,0.6155352480417755
405,elis_wilson,631,214,417,-199.79999999999993,0.33914421553090335,0.6608557844690967
406,blairmcdougall,2093,593,1500,-843.8000000000012,0.28332537028189203,0.716674629718108
407,SamGyimah,1315,548,767,-196.39999999999952,0.41673003802281366,0.5832699619771863
408,whyteleafedavid,1701,512,1189,-624.8000000000012,0.3009994121105232,0.6990005878894768
409,Hitesh_T,2059,696,1363,-606.8000000000005,0.3380281690140845,0.6619718309859155
410,sophiecooktalks,2318,885,1433,-452.0000000000024,0.3817946505608283,0.6182053494391717
411,OliHenman,2928,1236,1692,-422.80000000000064,0.42213114754098363,0.5778688524590164
412,timloughton,2740,993,1747,-693.000000000002,0.3624087591240876,0.6375912408759125
413,CllrAlanClark,1692,508,1184,-627.6000000000012,0.30023640661938533,0.6997635933806147
414,GregKnight,510,201,309,-101.40000000000009,0.3941176470588235,0.6058823529411764
415,carlminns,2361,591,1770,-1114.9999999999993,0.2503176620076239,0.7496823379923762
416,Caroline_Ansell,22,12,10,3.0,0.5454545454545454,0.45454545454545453
417,JakeyLambert,828,244,584,-319.2,0.2946859903381642,0.7053140096618358
418,StephenLloydEBN,280,93,187,-84.39999999999995,0.33214285714285713,0.6678571428571428
419,mimsdavies,2906,1197,1709,-445.4000000000019,0.411906400550585,0.588093599449415
420,jill4eastleigh,97,26,71,-39.400000000000006,0.26804123711340205,0.7319587628865979
421,Mike4Eastleigh,2851,949,1902,-892.2000000000014,0.3328656611715188,0.6671343388284813
422,ianpriestnerLD,2804,926,1878,-890.2000000000014,0.3302425106990014,0.6697574893009985
423,eddisburylabour,3,1,2,-0.6,0.3333333333333333,0.6666666666666666
424,Sandbach,2952,1006,1946,-892.7999999999998,0.3407859078590786,0.6592140921409214
425,liberalgrayedi,993,310,683,-343.80000000000047,0.3121852970795569,0.6878147029204431
426,PatsyKingEdEast,39,17,22,-4.8,0.4358974358974359,0.5641025641025641
427,IainMcGill,2685,788,1897,-1035.8000000000018,0.29348230912476725,0.7065176908752328
428,Martin_Veart,2851,819,2032,-1139.1999999999998,0.2872676253945984,0.7127323746054016
429,IanMurrayMP,1416,519,897,-361.0000000000002,0.3665254237288136,0.6334745762711864
430,MilesBriggsMSP,2703,889,1814,-858.2000000000004,0.32889382167961523,0.6711061783203848
431,FoysolChoudhury,1953,618,1335,-653.6000000000012,0.31643625192012287,0.6835637480798771
432,AishaJMir,259,83,176,-85.8,0.3204633204633205,0.6795366795366795
433,SandyBatho,33,13,20,-6.6,0.3939393939393939,0.6060606060606061
434,cajardineMP,1820,546,1274,-666.6000000000016,0.3,0.7
435,Mandytelford,1015,327,688,-332.6000000000002,0.3221674876847291,0.677832512315271
436,GonulDaniels,1011,387,624,-219.5999999999999,0.3827893175074184,0.6172106824925816
437,that_ed_gough,42,10,32,-22.0,0.23809523809523808,0.7619047619047619
438,justinmadders,2471,730,1741,-930.6000000000009,0.2954269526507487,0.7045730473492513
439,GoltonStewart,527,186,341,-139.9999999999999,0.35294117647058826,0.6470588235294118
440,AlecShelbrooke,1570,535,1035,-470.0000000000011,0.34076433121019106,0.6592356687898089
441,CliveEfford,982,359,623,-229.99999999999997,0.3655804480651731,0.6344195519348269
442,DHallMatthews,413,154,259,-94.99999999999999,0.3728813559322034,0.6271186440677966
443,MattHartley100,1559,557,1002,-400.80000000000103,0.35728030788967285,0.6427196921103271
444,nickdebois,2933,1029,1904,-796.800000000001,0.35083532219570407,0.649164677804296
445,nick_dacosta,1708,600,1108,-460.6000000000004,0.351288056206089,0.6487119437939111
446,joanryanEnfield,948,438,510,-57.60000000000003,0.4620253164556962,0.5379746835443038
447,DavidBurrowesUK,755,265,490,-212.1999999999999,0.3509933774834437,0.6490066225165563
448,BambosMP,189,70,119,-48.59999999999998,0.37037037037037035,0.6296296296296297
449,PippaMorganLD,325,115,210,-80.39999999999993,0.35384615384615387,0.6461538461538462
450,eleanor4epping,45,15,30,-15.799999999999997,0.3333333333333333,0.6666666666666666
451,lbpreston,1621,542,1079,-488.2000000000015,0.33436150524367675,0.6656384947563233
452,jon_whitehouse,810,222,588,-342.2000000000004,0.2740740740740741,0.725925925925926
453,EpsomEwellFocus,492,132,360,-218.19999999999985,0.2682926829268293,0.7317073170731707
454,ee_labour,444,136,308,-157.59999999999997,0.3063063063063063,0.6936936936936937
455,catkinson80,101,32,69,-31.4,0.31683168316831684,0.6831683168316832
456,tpearce003,2713,863,1850,-911.5999999999999,0.31809804644305195,0.681901953556948
457,waddertron,31,7,24,-16.799999999999997,0.22580645161290322,0.7741935483870968
458,CllrAndrewDavis,2085,637,1448,-758.8000000000018,0.30551558752997604,0.694484412470024
459,LanaHylands,369,132,237,-98.6,0.35772357723577236,0.6422764227642277
460,BenPBradshaw,2488,794,1694,-813.8000000000001,0.31913183279742763,0.6808681672025724
461,JTaghdissian,4,2,2,0.5999999999999999,0.5,0.5
462,CLaidlaw,723,282,441,-146.3999999999999,0.3900414937759336,0.6099585062240664
463,Craig_R_Martin,2800,884,1916,-954.4000000000005,0.3157142857142857,0.6842857142857143
464,SuellaFernandes,762,321,441,-103.59999999999994,0.421259842519685,0.5787401574803149
465,mwinnington,1716,603,1113,-467.4000000000014,0.3513986013986014,0.6486013986013986
466,dezairedale,89,29,60,-26.600000000000005,0.3258426966292135,0.6741573033707865
467,Helen_Whately,876,300,576,-245.8000000000001,0.3424657534246575,0.6575342465753424
468,samirjassal,37,18,19,-0.599999999999999,0.4864864864864865,0.5135135135135135
469,hinamalik85,2629,592,2037,-1148.0000000000025,0.22518067706352224,0.7748193229364777
470,EvaLilyFielding,4,0,4,-3.2,0.0,1.0
471,JackLopresti,418,164,254,-87.80000000000001,0.3923444976076555,0.6076555023923444
472,FaBSCLP,336,78,258,-162.39999999999998,0.23214285714285715,0.7678571428571429
473,Jeremy_Newmark,2782,1147,1635,-432.0000000000009,0.41229331416247306,0.5877066858375269
474,LynneBeaumont,246,92,154,-58.800000000000004,0.37398373983739835,0.6260162601626016
475,DamianCollins,2460,968,1492,-453.40000000000174,0.3934959349593496,0.6065040650406504
476,laurafd,253,61,192,-121.19999999999995,0.24110671936758893,0.758893280632411
477,Mark_J_Harper,417,147,270,-105.79999999999995,0.35251798561151076,0.6474820143884892
478,fivanmierlo,519,164,355,-177.79999999999978,0.3159922928709056,0.6840077071290944
479,sullivan_jed,583,166,417,-237.60000000000002,0.2847341337907376,0.7152658662092625
480,EdwardLeighMP,285,131,154,-20.599999999999998,0.45964912280701753,0.5403508771929825
481,derbyshire_cath,311,94,217,-113.59999999999992,0.3022508038585209,0.6977491961414791
482,meaglemp,2940,1007,1933,-847.4000000000011,0.34251700680272107,0.6574829931972789
483,AnnaMartinLD,1535,506,1029,-480.40000000000106,0.32964169381107494,0.6703583061889251
484,frankhindle,30,11,19,-5.599999999999999,0.36666666666666664,0.6333333333333333
485,IanMearnsMP,2872,938,1934,-931.4000000000008,0.3266016713091922,0.6733983286908078
486,Abbott4Gedling,78,30,48,-16.400000000000002,0.38461538461538464,0.6153846153846154
487,Vernon_Coaker,925,310,615,-284.40000000000015,0.33513513513513515,0.6648648648648648
488,medwaypaul,2694,738,1956,-1136.9999999999961,0.2739420935412027,0.7260579064587973
489,Rehman_Chishti,945,540,405,135.0000000000001,0.5714285714285714,0.42857142857142855
490,CllrAndyStamp,1497,571,926,-314.0000000000001,0.38142952571810285,0.6185704742818972
491,lottifairbanks,279,92,187,-88.59999999999998,0.32974910394265233,0.6702508960573477
492,FatenH4Labour,101,36,65,-27.000000000000004,0.3564356435643564,0.6435643564356436
493,MatthewJC93,297,103,194,-83.19999999999996,0.3468013468013468,0.6531986531986532
494,Katewatson67,245,81,164,-76.59999999999994,0.3306122448979592,0.6693877551020408
495,StuartCullen,60,18,42,-21.0,0.3,0.7
496,GlasgowPam,1058,364,694,-287.20000000000044,0.3440453686200378,0.6559546313799622
497,danielslaw,104,29,75,-43.8,0.27884615384615385,0.7211538461538461
498,PaulJSweeney,1753,597,1156,-525.400000000001,0.3405590416428979,0.6594409583571021
499,JW4GNE,414,113,301,-179.19999999999996,0.27294685990338163,0.7270531400966184
500,ChrisJLLand,546,161,385,-202.79999999999995,0.2948717948717949,0.7051282051282052
501,mgshanks,3018,1076,1942,-778.4000000000023,0.3565275016567263,0.6434724983432737
502,eileen_dinning,59,32,27,7.199999999999999,0.5423728813559322,0.4576271186440678
503,ewanhoyle,710,256,454,-183.5999999999999,0.36056338028169016,0.6394366197183099
504,Taylor_Muir54,1573,484,1089,-574.0000000000009,0.3076923076923077,0.6923076923076923
505,BenDC_,851,255,596,-324.0000000000001,0.299647473560517,0.700352526439483
506,haddow_thomas,171,62,109,-40.0,0.36257309941520466,0.6374269005847953
507,bellrebeccabell,251,78,173,-82.59999999999994,0.3107569721115538,0.6892430278884463
508,Altany,2581,733,1848,-1056.6,0.2839984502130957,0.7160015497869043
509,RichardGrahamUK,2012,799,1213,-370.20000000000016,0.397117296222664,0.602882703777336
510,jeremy4glos,1507,469,1038,-526.8000000000014,0.3112143331121433,0.6887856668878567
511,Baz_k,132,27,105,-71.39999999999996,0.20454545454545456,0.7954545454545454
512,Colin_J_Clark,126,69,57,11.399999999999997,0.5476190476190477,0.4523809523809524
513,kirstenRoseMuat,328,99,229,-118.99999999999994,0.3018292682926829,0.698170731707317
514,cj_dinenage,1938,822,1116,-253.79999999999993,0.4241486068111455,0.5758513931888545
515,alanejdurrant,307,72,235,-153.79999999999987,0.23452768729641693,0.7654723127035831
516,BruceTennent,12,5,7,-2.8,0.4166666666666667,0.5833333333333334
517,ToniaAntoniazzi,198,70,128,-57.79999999999998,0.35353535353535354,0.6464646464646465
518,Byron_Davies,896,346,550,-181.7999999999998,0.3861607142857143,0.6138392857142857
519,HowardWilliamEv,1180,450,730,-250.00000000000006,0.3813559322033898,0.6186440677966102
520,NickBoles,84,27,57,-28.4,0.32142857142857145,0.6785714285714286
521,AnitadayA,1955,618,1337,-659.0000000000009,0.31611253196930944,0.6838874680306906
522,barriefairbairn,200,46,154,-87.99999999999994,0.23,0.77
523,MandyGarford,1109,290,819,-440.0000000000026,0.26149684400360684,0.7385031559963932
524,JamesWillisLD,98,25,73,-43.00000000000001,0.25510204081632654,0.7448979591836735
525,jogideon,86,43,43,-0.20000000000000073,0.5,0.5
526,OnnMel,2496,850,1646,-710.8000000000018,0.3405448717948718,0.6594551282051282
527,BrandonLewis,2836,1167,1669,-427.000000000002,0.4114950634696756,0.5885049365303244
528,gylabour,386,128,258,-121.19999999999995,0.3316062176165803,0.6683937823834197
529,cs_adams,1029,359,670,-284.20000000000005,0.3488824101068999,0.6511175898931001
530,CarolineAttfiel,21,9,12,-3.0,0.42857142857142855,0.5714285714285714
531,mtpennycook,2882,822,2060,-1157.199999999998,0.28521859819569745,0.7147814018043026
532,ZoeFranklinLD,985,76,909,-827.5999999999998,0.07715736040609138,0.9228426395939087
533,AnneMilton,205,76,129,-45.2,0.37073170731707317,0.6292682926829268
534,HackneyAbbott,2333,734,1599,-787.8000000000018,0.3146163737676811,0.6853836262323189
535,hackneyamyg,734,197,537,-316.0000000000002,0.2683923705722071,0.7316076294277929
536,joerichards,704,234,470,-223.99999999999991,0.33238636363636365,0.6676136363636364
537,luke_r_parker,75,29,46,-14.000000000000002,0.38666666666666666,0.6133333333333333
538,DaveRaval,1084,356,728,-346.19999999999993,0.3284132841328413,0.6715867158671587
539,cwps9998,40,20,20,1.1999999999999993,0.5,0.5
540,JamesMorris,295,109,186,-76.39999999999998,0.3694915254237288,0.6305084745762712
541,Jamesdbaker1,2683,698,1985,-1222.1999999999982,0.2601565411852404,0.7398434588147595
542,Pearson4Halifax,1451,535,916,-349.6000000000003,0.36871123363197794,0.631288766368022
543,HollyLynch5,1231,483,748,-234.9999999999998,0.3923639317627945,0.6076360682372055
544,DavidDavisMP,206,100,106,-0.9999999999999964,0.4854368932038835,0.5145631067961165
545,holliedevanney,516,153,363,-197.7999999999999,0.29651162790697677,0.7034883720930233
546,rsbate,124,24,100,-70.4,0.1935483870967742,0.8064516129032258
547,mdlloyd,2,1,1,-0.20000000000000007,0.5,0.5
548,DerekTwiggMP,276,114,162,-41.999999999999986,0.41304347826086957,0.5869565217391305
549,charliedewhirst,14,6,8,-1.6,0.42857142857142855,0.5714285714285714
550,JoyceOnstad,491,148,343,-189.79999999999998,0.3014256619144603,0.6985743380855397
551,hammersmithandy,2903,1005,1898,-784.0000000000015,0.3461935928349983,0.6538064071650017
552,kirstyrallan,1326,414,912,-459.0000000000012,0.31221719457013575,0.6877828054298643
553,ClaireLLeyland,2527,958,1569,-536.4000000000026,0.37910565888405223,0.6208943411159478
554,TulipSiddiq,2053,738,1315,-532.0000000000008,0.3594739405747686,0.6405260594252313
555,Zuffar_Haq,2689,1063,1626,-485.8000000000014,0.3953142432130904,0.6046857567869096
556,NeilDotObrien,70,21,49,-24.800000000000004,0.3,0.7
557,MHLabourParty,354,114,240,-123.59999999999998,0.3220338983050847,0.6779661016949152
558,halfon4harlowMP,2537,1010,1527,-429.0000000000025,0.39810800157666537,0.6018919984233346
559,PhilWaiteHw,1349,447,902,-424.4000000000006,0.3313565604151223,0.6686434395848777
560,flynnhc,1298,460,838,-343.4000000000001,0.3543913713405239,0.6456086286594761
561,AJonesMP,252,87,165,-71.79999999999997,0.34523809523809523,0.6547619047619048
562,MarkJSewards,586,196,390,-167.39999999999986,0.33447098976109213,0.6655290102389079
563,BobBlackman,2432,1035,1397,-307.6000000000006,0.42557565789473684,0.5744243421052632
564,NavinShah2016,381,165,216,-38.60000000000005,0.4330708661417323,0.5669291338582677
565,HannahDavid_HW,1400,560,840,-252.9999999999998,0.4,0.6
566,andy_hagon,61,21,40,-16.999999999999996,0.3442622950819672,0.6557377049180327
567,MikeHillMP,274,120,154,-31.200000000000006,0.43795620437956206,0.5620437956204379
568,CllrCarlJackson,193,81,112,-25.199999999999996,0.41968911917098445,0.5803108808290155
569,domcgraham,2796,878,1918,-972.6000000000008,0.31402002861230327,0.6859799713876967
570,bernardjenkin,1580,635,945,-276.6000000000001,0.40189873417721517,0.5981012658227848
571,JRosalindScott,2349,808,1541,-669.6000000000018,0.3439761600681141,0.656023839931886
572,nickperrylibdem,1214,372,842,-436.4000000000006,0.30642504118616143,0.6935749588138386
573,AmberRuddHR,543,246,297,-46.39999999999999,0.4530386740331492,0.5469613259668509
574,paulgraylocal,442,125,317,-181.3999999999999,0.2828054298642534,0.7171945701357466
575,AlanMakMP,2142,953,1189,-194.3999999999997,0.4449112978524743,0.5550887021475257
576,billnewtondunn,21,10,11,-1.2000000000000002,0.47619047619047616,0.5238095238095238
577,johnmcdonnellMP,2281,745,1536,-716.4000000000018,0.32661113546690046,0.6733888645330995
578,gregsmith_uk,611,209,402,-185.4,0.34206219312602293,0.6579378068739771
579,HazelGrove_Lab,1264,419,845,-401.00000000000097,0.3314873417721519,0.6685126582278481
580,Lisa_Smart,280,92,188,-87.3999999999999,0.32857142857142857,0.6714285714285714
581,William_Wragg,799,328,471,-133.79999999999995,0.41051314142678347,0.5894868585732165
582,SallySymington,80,23,57,-31.400000000000006,0.2875,0.7125
583,Hemellabour,416,110,306,-178.39999999999984,0.2644230769230769,0.7355769230769231
584,jon_trickett,1168,390,778,-357.60000000000025,0.3339041095890411,0.666095890410959
585,hill4hendon,819,260,559,-281.80000000000007,0.31746031746031744,0.6825396825396826
586,mikekatz,2897,1096,1801,-625.6000000000029,0.37832240248532967,0.6216775975146703
587,Offord4Hendon,281,109,172,-54.20000000000002,0.3879003558718861,0.6120996441281139
588,JHowellUK,994,358,636,-269.2000000000001,0.36016096579476864,0.6398390342052314
589,HerefordLabour,1718,508,1210,-647.6000000000008,0.2956926658905704,0.7043073341094296
590,LucyHurds,216,84,132,-41.400000000000006,0.3888888888888889,0.6111111111111112
591,Jesse_Norman,1844,648,1196,-497.00000000000057,0.351409978308026,0.648590021691974
592,markargentLibDe,2991,960,2031,-1012.8000000000014,0.320962888665998,0.679037111334002
593,ChibahKatherine,1441,450,991,-484.4000000000017,0.31228313671061764,0.6877168632893824
594,PriskMark,1264,515,749,-214.1999999999996,0.4074367088607595,0.5925632911392406
595,geekofhearts,972,364,608,-217.79999999999964,0.37448559670781895,0.6255144032921811
596,FionaKatSmith,2775,865,1910,-967.8000000000017,0.3117117117117117,0.6882882882882883
597,FionaHallEU,1199,418,781,-342.79999999999995,0.3486238532110092,0.6513761467889908
598,GuyOpperman,2831,1118,1713,-558.8000000000012,0.3949134581419993,0.6050865418580007
599,ToryMemo,508,169,339,-154.9999999999999,0.33267716535433073,0.6673228346456693
600,LizMcInnes_MP,2860,1070,1790,-652.6000000000016,0.3741258741258741,0.6258741258741258
601,RuthGeorge6,20,9,11,-1.5999999999999996,0.45,0.55
602,BimAfolami,810,322,488,-146.7999999999999,0.39753086419753086,0.6024691358024692
603,Hugh_Annand,456,125,331,-198.19999999999993,0.2741228070175439,0.7258771929824561
604,jh66111,863,293,570,-257.99999999999994,0.33951332560834296,0.660486674391657
605,CampaignTim,658,242,416,-155.59999999999988,0.3677811550151976,0.6322188449848024
606,StephenCrosher,1946,580,1366,-726.8000000000018,0.29804727646454265,0.7019527235354573
607,Keir_Starmer,1596,722,874,-136.99999999999991,0.4523809523809524,0.5476190476190477
608,JuliaDockerill,45,23,22,0.5999999999999994,0.5111111111111111,0.4888888888888889
609,CllrRockyGill,2605,974,1631,-614.8000000000009,0.37389635316698655,0.6261036468330134
610,Dawn_Barnes,2985,881,2104,-1145.599999999998,0.295142378559464,0.704857621440536
611,emmalaneblue,28,12,16,-3.4000000000000004,0.42857142857142855,0.5714285714285714
612,CatherineWest1,2520,921,1599,-616.000000000001,0.36547619047619045,0.6345238095238095
613,horshamlabour,1551,519,1032,-475.80000000000115,0.3346228239845261,0.6653771760154739
614,MorwenMillson,2804,869,1935,-973.8000000000006,0.3099144079885877,0.6900855920114123
615,PaulEdgeworth,572,149,423,-253.19999999999987,0.26048951048951047,0.7395104895104895
616,bphillipsonMP,479,174,305,-116.79999999999991,0.36325678496868474,0.6367432150313153
617,KristyAdamsBlue,760,333,427,-84.19999999999989,0.4381578947368421,0.5618421052631579
618,carriehyndsLD,1750,620,1130,-460.8000000000016,0.35428571428571426,0.6457142857142857
619,peterkyle,2849,837,2012,-1076.7999999999984,0.2937872937872938,0.7062127062127063
620,SL_Benton,814,280,534,-236.80000000000013,0.343980343980344,0.6560196560196561
621,rodcantrill,110,39,71,-32.4,0.35454545454545455,0.6454545454545455
622,JDjanogly,457,155,302,-137.79999999999993,0.33916849015317285,0.6608315098468271
623,CambridgeMagpie,282,101,181,-70.2,0.35815602836879434,0.6418439716312057
624,KevinHorkin,610,221,389,-149.39999999999995,0.3622950819672131,0.6377049180327868
625,GrahamJones_MP,2888,1031,1857,-771.400000000002,0.356994459833795,0.643005540166205
626,RichBJC,2143,630,1513,-837.2000000000012,0.29398040130657954,0.7060195986934205
627,wesstreeting,2240,828,1412,-514.2000000000016,0.36964285714285716,0.6303571428571428
628,ChrisChapman86,554,188,366,-157.9999999999999,0.33935018050541516,0.6606498194945848
629,martinmccluskey,2809,828,1981,-1068.1999999999998,0.2947668209327163,0.7052331790672838
630,RRitchieC,180,45,135,-82.99999999999999,0.25,0.75
631,mgrobb,347,97,250,-148.79999999999998,0.27953890489913547,0.7204610951008645
632,gummerben,2469,894,1575,-598.4000000000024,0.362089914945322,0.637910085054678
633,Juvelad,154,62,92,-25.40000000000001,0.4025974025974026,0.5974025974025974
634,sandyofipswich,1363,488,875,-374.40000000000003,0.35803374908290536,0.6419662509170947
635,NBelfitt,458,148,310,-156.9999999999999,0.3231441048034934,0.6768558951965066
636,iowlabourparty,399,105,294,-180.39999999999995,0.2631578947368421,0.7368421052631579
637,_JamesTClark,328,124,204,-77.39999999999998,0.3780487804878049,0.6219512195121951
638,jeremycorbyn,2910,941,1969,-940.0000000000019,0.32336769759450174,0.6766323024054983
639,JasonTGC,1051,452,599,-124.39999999999989,0.4300666032350143,0.5699333967649858
640,AlainDesmier,295,98,197,-94.59999999999997,0.33220338983050846,0.6677966101694915
641,EmilyThornberry,2813,896,1917,-931.3999999999986,0.3185211517952364,0.6814788482047636
642,mkidnerLD,45,12,33,-20.6,0.26666666666666666,0.7333333333333333
643,Daniel_Thomas81,779,310,469,-138.59999999999988,0.3979460847240051,0.6020539152759948
644,Robin_Gwynn,133,53,80,-23.200000000000017,0.39849624060150374,0.6015037593984962
645,jarrowstevemp,216,84,132,-47.999999999999986,0.3888888888888889,0.6111111111111112
646,KeighleyLabour,20,6,14,-8.0,0.3,0.7
647,Matt4Keighley,478,141,337,-183.79999999999998,0.29497907949790797,0.7050209205020921
648,richdick,899,271,628,-330.0000000000003,0.3014460511679644,0.6985539488320356
649,BallySingh74,995,342,653,-285.00000000000006,0.3437185929648241,0.6562814070351759
650,backborwick,612,246,366,-98.39999999999989,0.4019607843137255,0.5980392156862745
651,emmadentcoad,2772,869,1903,-947.4000000000016,0.3134920634920635,0.6865079365079365
652,AnnabelMullin,1324,365,959,-563.6000000000007,0.2756797583081571,0.724320241691843
653,MickScrimshaw,879,259,620,-345.6000000000005,0.29465301478953354,0.7053469852104665
654,Laura4KandL,54,18,36,-15.999999999999998,0.3333333333333333,0.6666666666666666
655,ali_harper,167,38,129,-87.19999999999999,0.2275449101796407,0.7724550898203593
656,EdwardJDavey,1128,396,732,-303.40000000000026,0.35106382978723405,0.648936170212766
657,Elsiethered,467,144,323,-166.0,0.3083511777301927,0.6916488222698073
658,KarlTurnerMP,2114,704,1410,-651.0000000000016,0.3330179754020814,0.6669820245979187
659,DianaJohnsonMP,2264,922,1342,-361.4000000000002,0.40724381625441697,0.592756183745583
660,LiaNiciTownend,20,9,11,-1.3999999999999997,0.45,0.55
661,cllrmikeross,586,163,423,-233.39999999999984,0.2781569965870307,0.7218430034129693
662,EmmaHardyMP,2449,695,1754,-952.1999999999998,0.2837893017558187,0.7162106982441813
663,christinemackay,201,61,140,-71.79999999999998,0.3034825870646766,0.6965174129353234
664,clairethomas1,570,198,372,-157.19999999999993,0.3473684210526316,0.6526315789473685
665,CSkidmoreUK,698,310,388,-65.59999999999995,0.44412607449856734,0.5558739255014327
666,mthrel,1229,347,882,-507.2000000000008,0.2823433685923515,0.7176566314076485
667,karen4kingswood,675,234,441,-189.79999999999998,0.3466666666666667,0.6533333333333333
668,cllrdavedempsey,254,77,177,-95.59999999999998,0.3031496062992126,0.6968503937007874
669,LesleyLaird,3150,1182,1968,-719.200000000002,0.37523809523809526,0.6247619047619047
670,CarlCashman,1404,441,963,-479.00000000000097,0.3141025641025641,0.6858974358974359
671,Andrew_Hilland,137,47,90,-37.6,0.34306569343065696,0.656934306569343
672,VoteOllerenshaw,141,64,77,-12.599999999999998,0.45390070921985815,0.5460992907801419
673,CatSmithMP,936,306,630,-300.0000000000001,0.3269230769230769,0.6730769230769231
674,hilarybennmp,1100,440,660,-196.79999999999993,0.4,0.6
675,garethmdaviesuk,289,113,176,-55.6,0.39100346020761245,0.6089965397923875
676,andynash,2049,608,1441,-763.2000000000014,0.296730112249878,0.703269887750122
677,RichardBurgon,2627,896,1731,-762.200000000001,0.3410734678340312,0.6589265321659687
678,MrMatt_Robinson,1706,637,1069,-391.00000000000085,0.3733880422039859,0.6266119577960141
679,edsanderson,513,118,395,-267.99999999999994,0.2300194931773879,0.7699805068226121
680,FabianLeedsNE,104,55,49,2.8000000000000007,0.5288461538461539,0.47115384615384615
681,JCHannah77,1966,576,1390,-753.4000000000018,0.29298067141403866,0.7070193285859614
682,Stephenson_Ryan,1427,523,904,-352.20000000000033,0.3665031534688157,0.6334968465311843
683,GregMulholland1,2435,838,1597,-690.4000000000016,0.34414784394250514,0.6558521560574949
684,A_C_McGregor,933,305,628,-295.20000000000016,0.32690246516613075,0.6730975348338692
685,RachelReevesMP,2822,1042,1780,-675.0000000000006,0.3692416725726435,0.6307583274273565
686,Edward4East,713,280,433,-139.39999999999992,0.39270687237026647,0.6072931276297335
687,HarrishBigb5,31,11,20,-9.200000000000001,0.3548387096774194,0.6451612903225806
688,Jack2Hickey,626,210,416,-196.2,0.3354632587859425,0.6645367412140575
689,leicesterliz,2622,995,1627,-539.0000000000016,0.37948131197559115,0.6205186880244088
690,RKilpatrickMCR,246,80,166,-77.79999999999997,0.3252032520325203,0.6747967479674797
691,KellyMarieLD,2907,812,2095,-1193.6000000000008,0.2793257653938768,0.7206742346061231
692,mariacaulfield,2916,941,1975,-964.4000000000021,0.3227023319615912,0.6772976680384087
693,Chapman_Dan,53,17,36,-18.400000000000002,0.32075471698113206,0.6792452830188679
694,heidi_mp,2418,816,1602,-733.8000000000005,0.337468982630273,0.6625310173697271
695,PeterTFortune,1418,584,834,-213.39999999999998,0.4118476727785614,0.5881523272214386
696,Emily4LewE,537,164,373,-195.7999999999999,0.3054003724394786,0.6945996275605214
697,ShaunBaileyUK,1235,387,848,-408.8000000000012,0.3133603238866397,0.6866396761133603
698,elliereeves,373,138,235,-91.19999999999999,0.3699731903485255,0.6300268096514745
699,john4london,2890,1031,1859,-763.0000000000009,0.3567474048442907,0.6432525951557093
700,Bobby_Dean,1834,589,1245,-599.000000000001,0.3211559432933479,0.6788440567066522
701,vickyfoxcroft,815,298,517,-200.7999999999999,0.3656441717791411,0.6343558282208589
702,JohnCryerMP,248,56,192,-132.79999999999993,0.22580645161290322,0.7741935483870968
703,Laura__Farris,607,256,351,-81.39999999999992,0.42174629324546953,0.5782537067545305
704,benjaminsims,551,190,361,-155.79999999999984,0.3448275862068966,0.6551724137931034
705,Mike_Fabricant,2280,687,1593,-842.2000000000008,0.3013157894736842,0.6986842105263158
706,ChrisWorsey,778,247,531,-257.20000000000016,0.31748071979434445,0.6825192802056556
707,karlmccartney,1431,501,930,-385.600000000001,0.350104821802935,0.649895178197065
708,joancoombes,17,5,12,-6.6000000000000005,0.29411764705882354,0.7058823529411765
709,Kristoforbrown,1050,304,746,-404.60000000000065,0.2895238095238095,0.7104761904761905
710,Laura4Walton,232,62,170,-95.19999999999993,0.2672413793103448,0.7327586206896551
711,cllrkemp,1724,547,1177,-586.0000000000007,0.31728538283062646,0.6827146171693735
712,timson_dj,3090,845,2245,-1318.7999999999938,0.27346278317152106,0.7265372168284789
713,rheawolfson,1013,311,702,-351.40000000000106,0.3070088845014807,0.6929911154985192
714,RoryDanielsLD,605,204,401,-183.59999999999997,0.3371900826446281,0.6628099173553719
715,NiaGriffithMP,706,281,425,-138.59999999999997,0.3980169971671388,0.6019830028328612
716,jewelmiah,412,137,275,-123.79999999999993,0.3325242718446602,0.6674757281553398
717,NickyMorgan01,1944,769,1175,-355.40000000000043,0.3955761316872428,0.6044238683127572
718,Dunne4Ludlow,522,246,276,-27.600000000000005,0.47126436781609193,0.5287356321839081
719,CKConservative,342,171,171,-3.1999999999999984,0.5,0.5
720,CllrRFM,108,27,81,-50.40000000000001,0.25,0.75
721,dean_r,278,122,156,-24.40000000000002,0.43884892086330934,0.5611510791366906
722,andymstrange,138,44,94,-40.40000000000002,0.3188405797101449,0.6811594202898551
723,richarddflowers,2610,771,1839,-1007.000000000001,0.29540229885057473,0.7045977011494253
724,Puttick4Macc,389,130,259,-119.59999999999992,0.3341902313624679,0.6658097686375322
725,DavidRutley,527,224,303,-70.80000000000001,0.4250474383301708,0.5749525616698292
726,theresa_may,276,111,165,-43.6,0.40217391304347827,0.5978260869565217
727,emilyfermor,753,260,493,-210.80000000000004,0.3452855245683931,0.6547144754316069
728,HelenGrantMP,983,417,566,-136.19999999999996,0.4242115971515768,0.5757884028484231
729,allen_m_simpson,365,131,234,-95.59999999999997,0.3589041095890411,0.6410958904109589
730,Y_FovargueMP,1112,359,753,-370.6000000000005,0.322841726618705,0.677158273381295
731,EdwardsEconomy,1246,295,951,-614.8000000000006,0.23675762439807382,0.7632423756019262
732,zoeimogen,1776,417,1359,-875.800000000001,0.23479729729729729,0.7652027027027027
733,JWhittingdale,55,29,26,3.7999999999999994,0.5272727272727272,0.4727272727272727
734,johnbridges51,32,6,26,-18.799999999999997,0.1875,0.8125
735,XXingang,402,146,256,-97.59999999999997,0.36318407960199006,0.6368159203980099
736,Afzal4Gorton,561,238,323,-77.80000000000008,0.42424242424242425,0.5757575757575758
737,jackiepearcey,2345,677,1668,-922.4000000000002,0.2886993603411514,0.7113006396588486
738,sarah_heald,576,228,348,-117.60000000000002,0.3958333333333333,0.6041666666666666
739,johnleechmcr,2808,809,1999,-1107.1999999999994,0.2881054131054131,0.7118945868945868
740,JeffSmithetc,1820,686,1134,-403.60000000000036,0.3769230769230769,0.6230769230769231
741,Anita4Mansfield,115,45,70,-21.600000000000005,0.391304347826087,0.6086956521739131
742,mpntod,1677,569,1108,-501.60000000000105,0.3392963625521765,0.6607036374478235
743,mcneil_tom,852,289,563,-243.9999999999998,0.3392018779342723,0.6607981220657277
744,spelmanc,1096,427,669,-228.99999999999974,0.3895985401459854,0.6104014598540146
745,SWEValleys,537,137,400,-236.39999999999972,0.25512104283054005,0.74487895716946
746,GeraldJonesLAB,2823,1154,1669,-475.60000000000025,0.4087849805171803,0.5912150194828197
747,CllrPauline,282,93,189,-91.80000000000004,0.32978723404255317,0.6702127659574468
748,NadineDorries,2677,831,1846,-912.6000000000028,0.3104221143070601,0.6895778856929399
749,lm_french,691,221,470,-232.19999999999987,0.31982633863965265,0.6801736613603473
750,Meades4MidBeds,1029,372,657,-257.7999999999999,0.36151603498542273,0.6384839650145773
751,Pauline_Latham,490,227,263,-29.800000000000015,0.463265306122449,0.536734693877551
752,Alison4MidDerby,232,75,157,-77.79999999999998,0.3232758620689655,0.6767241379310345
753,vikki4mdnp,2599,878,1721,-797.4000000000011,0.33782223932281646,0.6621777606771835
754,Michael4MDNP,996,408,588,-159.1999999999999,0.40963855421686746,0.5903614457831325
755,Freeman_George,2338,939,1399,-412.60000000000053,0.4016253207869974,0.5983746792130026
756,Fionna_T_,764,285,479,-178.59999999999994,0.3730366492146597,0.6269633507853403
757,Mountainin2015,2894,1017,1877,-803.4000000000013,0.35141672425708365,0.6485832757429164
758,sjo400,2004,651,1353,-641.6000000000016,0.3248502994011976,0.6751497005988024
759,NSoames,2069,732,1337,-560.6000000000006,0.3537941034316095,0.6462058965683906
760,HuddlestonNigel,1905,801,1104,-266.5999999999999,0.4204724409448819,0.5795275590551181
761,rowlem,26,11,15,-4.0,0.4230769230769231,0.5769230769230769
762,AndyMcDonaldMP,606,228,378,-134.8,0.37623762376237624,0.6237623762376238
763,jcbyoung,2761,896,1865,-910.8000000000022,0.3245201014125317,0.6754798985874683
764,ChrisasDickens,223,72,151,-79.19999999999999,0.32286995515695066,0.6771300448430493
765,tracy_harvey,193,51,142,-88.59999999999997,0.26424870466321243,0.7357512953367875
766,MarkLancasterMK,886,360,526,-144.59999999999982,0.40632054176072235,0.5936794582392777
767,CharlynnePullen,133,52,81,-24.200000000000017,0.39097744360902253,0.6090225563909775
768,Tahirmaher2,41,13,28,-13.999999999999998,0.3170731707317073,0.6829268292682927
769,hfoneill,36,20,16,4.3999999999999995,0.5555555555555556,0.4444444444444444
770,iainastewart,345,146,199,-46.59999999999998,0.42318840579710143,0.5768115942028985
771,aliciakearns,2654,1008,1646,-592.8000000000005,0.37980406932931426,0.6201959306706858
772,clmathys,308,96,212,-98.79999999999994,0.3116883116883117,0.6883116883116883
773,Siobhain_MP,2839,1030,1809,-678.4000000000025,0.3628038041563931,0.6371961958436069
774,PaulKenLD,3081,933,2148,-1127.5999999999992,0.3028237585199611,0.697176241480039
775,DavidTCDavies,1264,478,786,-288.99999999999943,0.37816455696202533,0.6218354430379747
776,veronicakgerman,67,23,44,-16.200000000000006,0.34328358208955223,0.6567164179104478
777,ruthjoneswales,298,98,200,-93.59999999999995,0.3288590604026846,0.6711409395973155
778,GlynDavies,1401,530,871,-298.60000000000025,0.3783012134189864,0.6216987865810135
779,DoddsJane,1661,463,1198,-699.800000000001,0.27874774232390126,0.7212522576760987
780,Iwan_Wyn_Llafur,32,10,22,-11.6,0.3125,0.6875
781,Douglas4Moray,2413,910,1503,-550.4000000000009,0.37712391214256114,0.6228760878574389
782,davidmorrisml,275,97,178,-74.20000000000002,0.3527272727272727,0.6472727272727272
783,Matt_Severn,2568,764,1804,-986.2000000000003,0.29750778816199375,0.7024922118380063
784,andreajenkyns,1469,541,928,-352.20000000000016,0.3682777399591559,0.6317222600408441
785,angela_feeney,1035,275,760,-450.2000000000005,0.26570048309178745,0.7342995169082126
786,GallacherMeghan,2294,683,1611,-865.8000000000011,0.2977332170880558,0.7022667829119442
787,Ealasaid_MacD,110,31,79,-45.2,0.2818181818181818,0.7181818181818181
788,DanielForWI,109,27,82,-50.6,0.24770642201834864,0.7522935779816514
789,orlalowe,32,13,19,-5.3999999999999995,0.40625,0.59375
790,harrylib100,206,65,141,-73.99999999999997,0.3155339805825243,0.6844660194174758
791,LabourNFW,451,147,304,-149.7999999999999,0.3259423503325942,0.6740576496674058
792,TerryScrivenLD,8,2,6,-3.5999999999999996,0.25,0.75
793,DesmondSwayne,205,88,117,-23.600000000000005,0.4292682926829268,0.5707317073170731
794,RobertJenrick,1198,534,664,-107.79999999999976,0.44574290484140233,0.5542570951585977
795,Chantal4Labour,106,36,70,-31.799999999999997,0.33962264150943394,0.660377358490566
796,DavidWatts12,1468,458,1010,-511.40000000000106,0.3119891008174387,0.6880108991825613
797,RichardBenyonMP,1498,532,966,-404.2000000000003,0.35514018691588783,0.6448598130841121
798,JudithBuntingLD,2703,763,1940,-1117.4000000000008,0.2822789493155753,0.7177210506844247
799,cott_nick,1104,348,756,-387.6000000000001,0.31521739130434784,0.6847826086956522
800,ChiOnwurah,2552,943,1609,-605.8000000000012,0.3695141065830721,0.6304858934169278
801,skitchen82,127,54,73,-15.399999999999999,0.4251968503937008,0.5748031496062992
802,NewcastleEastLD,2349,734,1615,-827.4000000000034,0.31247339293316306,0.687526607066837
803,DuncanCCrute,32,18,14,4.6,0.5625,0.4375
804,CatMcKinnell,2209,957,1252,-240.7999999999997,0.4332277048438207,0.5667722951561792
805,owenlmeredith,2896,758,2138,-1281.7999999999975,0.2617403314917127,0.7382596685082873
806,natasghar,2920,847,2073,-1145.3999999999985,0.29006849315068495,0.709931506849315
807,jessicamordenmp,706,242,464,-201.19999999999985,0.34277620396600567,0.6572237960339944
808,PaulFlynnMP,1905,740,1165,-380.4000000000005,0.3884514435695538,0.6115485564304461
809,AJonesEvans,345,125,220,-84.39999999999998,0.36231884057971014,0.6376811594202898
810,AnneMarieMorris,177,64,113,-40.39999999999998,0.3615819209039548,0.6384180790960452
811,james_labour,309,70,239,-152.00000000000003,0.22653721682847897,0.7734627831715211
812,YvetteCooperMP,1835,697,1138,-385.20000000000095,0.3798365122615804,0.6201634877384197
813,crimicans98,329,106,223,-103.59999999999994,0.3221884498480243,0.6778115501519757
814,joyinthisplace,495,95,400,-236.39999999999938,0.1919191919191919,0.8080808080808081
815,scottmann4NC,511,218,293,-66.8,0.42661448140900193,0.5733855185909981
816,markcann,14,4,10,-5.0,0.2857142857142857,0.7142857142857143
817,NickHarveyND,101,33,68,-34.199999999999996,0.32673267326732675,0.6732673267326733
818,PeterNorthDevon,1005,402,603,-171.59999999999977,0.4,0.6
819,Simon4NDorset,2353,951,1402,-398.6000000000007,0.40416489587760307,0.5958351041223969
820,Pat4NorthDorset,43,10,33,-19.400000000000002,0.23255813953488372,0.7674418604651163
821,Frankshivers,14,4,10,-6.4,0.2857142857142857,0.7142857142857143
822,TishGlossop,68,25,43,-15.8,0.36764705882352944,0.6323529411764706
823,KevanJonesMP,722,280,442,-149.39999999999998,0.3878116343490305,0.6121883656509696
824,cmartinLD,290,79,211,-118.7999999999999,0.27241379310344827,0.7275862068965517
825,AlistairBurtUK,2964,1217,1747,-459.40000000000083,0.41059379217273956,0.5894062078272605
826,juliman66,589,210,379,-158.60000000000002,0.3565365025466893,0.6434634974533107
827,cllrdarrenfower,1347,332,1015,-662.8000000000001,0.24647364513734224,0.7535263548626577
828,KRustidge,258,93,165,-68.2,0.36046511627906974,0.6395348837209303
829,Lee4NED,155,57,98,-39.59999999999999,0.36774193548387096,0.632258064516129
830,rosalindgarton,24,12,12,-0.19999999999999996,0.5,0.5
831,Elizabeth4NEF,66,19,47,-25.800000000000004,0.2878787878787879,0.7121212121212122
832,GrahamCockarill,19,1,18,-17.0,0.05263157894736842,0.9473684210526315
833,NickyShepard,2283,689,1594,-847.600000000001,0.3017958826106001,0.6982041173893999
834,dougmswanney,583,195,388,-177.9999999999998,0.3344768439108062,0.6655231560891939
835,Robin34t,253,88,165,-74.20000000000002,0.34782608695652173,0.6521739130434783
836,jeanie4northhfd,232,71,161,-86.6,0.30603448275862066,0.6939655172413793
837,StephenBBurke,1873,747,1126,-336.0000000000002,0.398825413774693,0.601174586225307
838,normanlamb,1990,655,1335,-618.600000000001,0.32914572864321606,0.6708542713567839
839,James4NNorfolk,116,57,59,-0.9999999999999989,0.49137931034482757,0.5086206896551724
840,graeme_currie1,175,54,121,-66.2,0.30857142857142855,0.6914285714285714
841,OwenPaterson,1006,456,550,-82.60000000000005,0.4532803180914513,0.5467196819085487
842,tomssthornhill,214,75,139,-57.39999999999999,0.35046728971962615,0.6495327102803738
843,NSomersetLDs,57,32,25,8.2,0.5614035087719298,0.43859649122807015
844,LiamFox,1563,674,889,-195.99999999999974,0.4312220089571337,0.5687779910428663
845,dempsey4labour,109,41,68,-26.4,0.3761467889908257,0.6238532110091743
846,JustinTomlinson,1108,442,666,-198.39999999999986,0.3989169675090253,0.6010830324909747
847,rehalfrances,231,77,154,-77.2,0.3333333333333333,0.6666666666666666
848,GlindonMary,117,50,67,-14.000000000000004,0.42735042735042733,0.5726495726495726
849,gm_stone,46,14,32,-17.000000000000004,0.30434782608695654,0.6956521739130435
850,james_cox12,936,227,709,-447.8000000000007,0.24252136752136752,0.7574786324786325
851,NWBLabour,232,72,160,-84.60000000000002,0.3103448275862069,0.6896551724137931
852,craig4nwarks,2772,1184,1588,-358.2000000000002,0.42712842712842713,0.5728715728715729
853,cllrbridget,1642,518,1124,-564.0000000000008,0.315468940316687,0.6845310596833131
854,LauraPidcockMP,495,211,284,-65.40000000000002,0.4262626262626263,0.5737373737373738
855,OwenTemple2,246,87,159,-69.6,0.35365853658536583,0.6463414634146342
856,AndyFitchet,155,41,114,-70.39999999999998,0.2645161290322581,0.7354838709677419
857,kitmalthouse,523,222,301,-71.6,0.42447418738049714,0.5755258126195029
858,ACPayton,19,4,15,-9.799999999999999,0.21052631578947367,0.7894736842105263
859,ABridgen,213,91,122,-26.8,0.4272300469483568,0.5727699530516432
860,rm113,678,182,496,-291.79999999999995,0.26843657817109146,0.7315634218289085
861,JoRust45,2147,656,1491,-764.2000000000005,0.3055426176059618,0.6944573823940382
862,JGray,50,16,34,-15.0,0.32,0.68
863,BrianMathew4NW,201,62,139,-73.99999999999999,0.30845771144278605,0.6915422885572139
864,Michael_Ellis1,397,205,192,20.399999999999974,0.5163727959697733,0.4836272040302267
865,Sally_Keeble,1020,362,658,-269.60000000000014,0.35490196078431374,0.6450980392156863
866,GeorgeSmid,284,88,196,-99.19999999999997,0.30985915492957744,0.6901408450704225
867,JillHopeLibDem,38,20,18,0.7999999999999985,0.5263157894736842,0.47368421052631576
868,ALewerMBE,939,380,559,-165.19999999999976,0.40468583599574015,0.5953141640042598
869,kevinmckeever,2603,796,1807,-919.2000000000019,0.3058009988474837,0.6941990011525163
870,Chris4NorwichN,163,66,97,-26.200000000000006,0.4049079754601227,0.5950920245398773
871,HughinNorfolk,128,32,96,-63.4,0.25,0.75
872,NorwichChloe,698,269,429,-145.79999999999993,0.3853868194842407,0.6146131805157593
873,LanaHempsall,168,50,118,-61.40000000000001,0.2976190476190476,0.7023809523809523
874,labourlewis,3197,992,2205,-1118.5999999999979,0.31029089771660934,0.6897091022833907
875,JamesWrightLD,541,184,357,-154.99999999999991,0.34011090573012936,0.6598890942698706
876,hollidb,2699,1044,1655,-559.000000000001,0.38680992960355687,0.6131900703964431
877,Jack_Tinley,44,17,27,-5.8,0.38636363636363635,0.6136363636363636
878,LilianGreenwood,2709,928,1781,-772.6000000000016,0.34256183093392395,0.657438169066076
879,JaneMHunt,155,64,91,-27.2,0.4129032258064516,0.5870967741935483
880,PhilipJ68243370,323,80,243,-151.1999999999999,0.2476780185758514,0.7523219814241486
881,Marcus4Nuneaton,968,380,588,-177.39999999999986,0.3925619834710744,0.6074380165289256
882,LukeGrahamMP,461,154,307,-144.59999999999994,0.33405639913232105,0.665943600867679
883,Yellowsiskin,433,138,295,-139.79999999999993,0.3187066974595843,0.6812933025404158
884,CPJElmore,2543,957,1586,-559.6000000000021,0.3763271726307511,0.6236728273692489
885,JamieWallisCons,10,0,10,-9.8,0.0,1.0
886,JBrokenshire,418,192,226,-24.200000000000024,0.45933014354066987,0.5406698564593302
887,DannyHackett,326,87,239,-142.19999999999996,0.2668711656441718,0.7331288343558282
888,Drew1403,828,280,548,-247.79999999999995,0.33816425120772947,0.6618357487922706
889,Debbie_abrahams,2276,663,1613,-866.0000000000023,0.29130052724077327,0.7086994727592267
890,JonathanSmithLD,58,21,37,-15.999999999999998,0.3620689655172414,0.6379310344827587
891,garthharkness,619,130,489,-337.2000000000002,0.210016155088853,0.789983844911147
892,robina4labour17,141,47,94,-45.20000000000001,0.3333333333333333,0.6666666666666666
893,acarmichael4mp,1055,368,687,-313.6000000000002,0.34881516587677724,0.6511848341232227
894,jhalcrojohnston,3036,873,2163,-1201.7999999999986,0.2875494071146245,0.7124505928853755
895,alexfeakes,1682,572,1110,-478.0000000000016,0.3400713436385256,0.6599286563614745
896,JoJohnsonUK,800,385,415,-12.800000000000006,0.48125,0.51875
897,cllrbartington,566,246,320,-65.4,0.43462897526501765,0.5653710247349824
898,DrKirstenJ,1339,522,817,-254.19999999999965,0.3898431665421957,0.6101568334578044
899,nicolablackwood,1268,520,748,-197.19999999999982,0.41009463722397477,0.5899053627760252
900,LaylaMoran,842,211,631,-373.8000000000013,0.2505938242280285,0.7494061757719715
901,MarieTidball,124,45,79,-35.599999999999994,0.3629032258064516,0.6370967741935484
902,AlisonJDowling,151,50,101,-49.600000000000016,0.33112582781456956,0.6688741721854304
903,cllrwblackburn,739,230,509,-252.39999999999998,0.3112313937753721,0.6887686062246279
904,Andrew4Pendle,2917,1188,1729,-484.6000000000014,0.4072677408296195,0.5927322591703805
905,angelasmithmp,2094,723,1371,-561.0000000000019,0.3452722063037249,0.6547277936962751
906,NicolaFWilson,53,20,33,-11.000000000000002,0.37735849056603776,0.6226415094339622
907,Lola__McEvoy,294,112,182,-62.3999999999999,0.38095238095238093,0.6190476190476191
908,RoryStewartUK,1306,541,765,-198.8000000000001,0.41424196018376724,0.5857580398162328
909,CllrPeterBarret,380,78,302,-216.99999999999994,0.20526315789473684,0.7947368421052632
910,IanDuncanHMG,2461,830,1631,-754.4000000000013,0.33726127590410404,0.662738724095896
911,DavidHRoemmele,39,11,28,-16.2,0.28205128205128205,0.717948717948718
912,Stewart4Pboro,2922,972,1950,-843.8000000000036,0.3326488706365503,0.6673511293634496
913,FionaOnasanyaMP,290,76,214,-124.39999999999992,0.2620689655172414,0.7379310344827587
914,sue_dann,764,240,524,-258.4000000000001,0.31413612565445026,0.6858638743455497
915,JohnnyMercerUK,2848,1057,1791,-649.2000000000024,0.3711376404494382,0.6288623595505618
916,olivercolvile,744,259,485,-210.19999999999996,0.3481182795698925,0.6518817204301075
917,juliette_ash,51,18,33,-13.800000000000002,0.35294117647058826,0.6470588235294118
918,CllrMikePowell,1537,430,1107,-642.2000000000003,0.2797657774886142,0.7202342225113858
919,OwenSmith_MP,2342,811,1531,-666.2000000000011,0.34628522630230574,0.6537147736976943
920,RobertSyms,2109,829,1280,-415.00000000000074,0.3930772878141299,0.6069227121858701
921,esbagshaw,2943,872,2071,-1110.5999999999995,0.2962962962962963,0.7037037037037037
922,FitzMP,2323,830,1493,-602.6000000000017,0.3572965992251399,0.6427034007748601
923,wilford2017,536,217,319,-99.2,0.4048507462686567,0.5951492537313433
924,RumalKhan,114,52,62,-10.600000000000001,0.45614035087719296,0.543859649122807
925,PompeyToryParty,644,279,365,-73.00000000000003,0.4332298136645963,0.5667701863354038
926,darrensandersld,692,229,463,-217.99999999999997,0.3309248554913295,0.6690751445086706
927,FlickD,542,239,303,-52.20000000000002,0.44095940959409596,0.559040590405904
928,sjmorganuk,1285,400,885,-454.40000000000066,0.311284046692607,0.688715953307393
929,geraldvjuk,473,163,310,-136.19999999999993,0.34460887949260044,0.6553911205073996
930,SCrabbPembs,606,310,296,24.799999999999976,0.5115511551155115,0.4884488448844885
931,bobkilmister,25,4,21,-15.8,0.16,0.84
932,Philippa4Pembs,2287,905,1382,-426.20000000000124,0.39571491036292084,0.6042850896370792
933,kevcow,1027,274,753,-453.00000000000097,0.2667964946445959,0.7332035053554041
934,Neil4Preston,452,142,310,-140.19999999999987,0.3141592920353982,0.6858407079646017
935,StuartAndrew,712,230,482,-229.20000000000002,0.32303370786516855,0.6769662921348315
936,JustineGreening,1291,655,636,32.00000000000001,0.5073586367157242,0.49264136328427577
937,MercerRyanJ,316,99,217,-102.19999999999989,0.31329113924050633,0.6867088607594937
938,neerajpatil,91,20,71,-39.200000000000024,0.21978021978021978,0.7802197802197802
939,Marky_Daniels,67,19,48,-27.8,0.2835820895522388,0.7164179104477612
940,MattRodda,569,228,341,-101.79999999999995,0.4007029876977153,0.5992970123022847
941,RobWilson_RDG,2822,1259,1563,-253.40000000000109,0.44613749114103474,0.5538625088589653
942,DrJennyWoods,132,41,91,-44.60000000000001,0.3106060606060606,0.6893939393939394
943,livbailey,370,149,221,-59.59999999999993,0.4027027027027027,0.5972972972972973
944,merioconnell,62,19,43,-20.600000000000005,0.3064516129032258,0.6935483870967742
945,AlokSharma_RDG,1601,686,915,-195.80000000000007,0.42848219862585885,0.5715178013741412
946,RebeccaBlake31,40,10,30,-18.400000000000006,0.25,0.75
947,susanjuned,187,59,128,-63.40000000000001,0.3155080213903743,0.6844919786096256
948,TobyBrampton,334,97,237,-129.79999999999995,0.2904191616766467,0.7095808383233533
949,RhonddaBryant,1928,489,1439,-883.9999999999999,0.25363070539419086,0.7463692946058091
950,KarenClydach,2459,669,1790,-1039.6000000000008,0.272061813745425,0.7279381862545751
951,david4rv,281,95,186,-86.19999999999997,0.33807829181494664,0.6619217081850534
952,JesmondDan,425,162,263,-83.19999999999997,0.3811764705882353,0.6188235294117647
953,ZacGoldsmith,2095,871,1224,-264.4000000000004,0.41575178997613366,0.5842482100238664
954,sarahjolney1,1107,309,798,-447.8000000000014,0.2791327913279133,0.7208672086720868
955,andykelly,97,22,75,-50.80000000000001,0.2268041237113402,0.7731958762886598
956,TonyLloydMP,2735,1175,1560,-340.40000000000117,0.4296160877513711,0.5703839122486288
957,CllrMurray,250,76,174,-91.59999999999998,0.304,0.696
958,KellyTolhurst,673,290,383,-77.00000000000009,0.4309063893016345,0.5690936106983655
959,PieDalton,1841,555,1286,-670.2000000000013,0.30146659424225963,0.6985334057577404
960,JamesDuddridge,1672,612,1060,-427.6000000000002,0.3660287081339713,0.6339712918660287
961,Peter4MP,144,34,110,-69.4,0.2361111111111111,0.7638888888888888
962,GigiMaltese,1585,450,1135,-629.8000000000018,0.28391167192429023,0.7160883280757098
963,AndrewRosindell,1027,436,591,-135.79999999999984,0.42453748782862705,0.5754625121713729
964,carolinenokes,1616,667,949,-241.79999999999998,0.4127475247524752,0.5872524752475248
965,darrenpaffey,2134,803,1331,-473.80000000000115,0.37628865979381443,0.6237113402061856
966,jeanmedavis,1588,507,1081,-538.6000000000012,0.31926952141057935,0.6807304785894207
967,alysonbarnes17,1787,580,1207,-582.6000000000018,0.3245663122551763,0.6754336877448237
968,JakeBerry,504,168,336,-148.99999999999994,0.3333333333333333,0.6666666666666666
969,KevinBarronMP,674,192,482,-271.20000000000005,0.28486646884273,0.7151335311572701
970,KatieP4RotherV,215,73,142,-66.2,0.3395348837209302,0.6604651162790698
971,SarahChampionMP,1960,603,1357,-676.8000000000013,0.3076530612244898,0.6923469387755102
972,claire4rugby,390,142,248,-96.8,0.3641025641025641,0.6358974358974359
973,MarkPawsey,661,270,391,-103.99999999999999,0.4084720121028744,0.5915279878971256
974,JerryRoodhouse,297,86,211,-119.59999999999997,0.2895622895622896,0.7104377104377104
975,alexcunliffe4mp,69,16,53,-30.600000000000016,0.2318840579710145,0.7681159420289855
976,NickHurdUK,1941,811,1130,-281.40000000000015,0.41782586295723856,0.5821741370427614
977,rebeccalury,595,198,397,-181.39999999999978,0.33277310924369746,0.6672268907563025
978,FionaDentLabour,2504,817,1687,-819.6000000000006,0.3262779552715655,0.6737220447284346
979,PhilipHammondUK,672,364,308,57.59999999999995,0.5416666666666666,0.4583333333333333
980,RW4Vincent,476,130,346,-201.19999999999993,0.27310924369747897,0.726890756302521
981,CllrDavidMellen,1365,624,741,-86.8,0.45714285714285713,0.5428571428571428
982,DoreJayne,192,71,121,-47.000000000000014,0.3697916666666667,0.6302083333333334
983,Robert4LibDems,1148,339,809,-440.0000000000008,0.2952961672473868,0.7047038327526133
984,AlanDuncanMP,328,159,169,-5.999999999999996,0.4847560975609756,0.5152439024390244
985,heatherisone,218,46,172,-121.59999999999998,0.21100917431192662,0.7889908256880734
986,RandMLibDems,808,271,537,-234.39999999999978,0.3353960396039604,0.6646039603960396
987,KemiBadenoch,288,77,211,-122.19999999999993,0.2673611111111111,0.7326388888888888
988,SWLabour,317,104,213,-96.59999999999995,0.3280757097791798,0.6719242902208202
989,Mike4Walden,193,65,128,-54.00000000000002,0.33678756476683935,0.6632124352331606
990,RLong_Bailey,1030,293,737,-358.0000000000006,0.28446601941747574,0.7155339805825243
991,1tomcorbin,828,256,572,-295.3999999999999,0.30917874396135264,0.6908212560386473
992,JohnGlenUK,326,156,170,-9.800000000000002,0.4785276073619632,0.5214723926380368
993,paulsample2020,912,221,691,-454.40000000000043,0.24232456140350878,0.7576754385964912
994,NicDakinMP,2632,904,1728,-724.8000000000029,0.3434650455927052,0.6565349544072948
995,RykDownes,767,196,571,-336.79999999999984,0.25554106910039115,0.7444589308996089
996,DehennaDavison,972,291,681,-362.8000000000006,0.2993827160493827,0.7006172839506173
997,spsallidas,442,145,297,-139.59999999999994,0.32805429864253394,0.6719457013574661
998,MPphilwilson,1991,765,1226,-421.40000000000043,0.3842290306378704,0.6157709693621296
999,Bill_Esterson,2511,746,1765,-960.2000000000006,0.29709279171644765,0.7029072082835524
1000,CllrDanLewis,111,24,87,-59.800000000000004,0.21621621621621623,0.7837837837837838
1001,nadams,772,295,477,-167.59999999999994,0.38212435233160624,0.6178756476683938
1002,DavidBowgett,43,11,32,-19.799999999999997,0.2558139534883721,0.7441860465116279
1003,chrisclarkcpfc,945,286,659,-331.00000000000045,0.30264550264550266,0.6973544973544974
1004,PaulBlomfieldMP,1077,432,645,-197.3999999999995,0.4011142061281337,0.5988857938718662
1005,shaffaqmohd,980,343,637,-274.4000000000001,0.35,0.65
1006,nick_clegg,410,124,286,-145.99999999999986,0.3024390243902439,0.697560975609756
1007,IGWalker,33,10,23,-12.4,0.30303030303030304,0.696969696969697
1008,LouHaigh,2931,879,2052,-1093.999999999999,0.2998976458546571,0.7001023541453428
1009,JoeOttenX,2892,847,2045,-1137.6000000000006,0.29287690179806364,0.7071230982019364
1010,Mark_Spencer,549,204,345,-126.99999999999986,0.37158469945355194,0.6284153005464481
1011,Bex_the_Green,762,212,550,-317.8,0.2782152230971129,0.7217847769028871
1012,PhilipDaviesUK,2774,913,1861,-874.8000000000005,0.32912761355443404,0.670872386445566
1013,HannahFAbbey,691,218,473,-238.79999999999984,0.3154848046309696,0.6845151953690304
1014,daniel4shrews,20,9,11,-1.6,0.45,0.55
1015,Keith_Nevols,112,22,90,-61.59999999999999,0.19642857142857142,0.8035714285714286
1016,MicalmusRolfe,132,36,96,-53.400000000000006,0.2727272727272727,0.7272727272727273
1017,JulianSmithUK,926,413,513,-86.99999999999996,0.44600431965442766,0.5539956803455723
1018,RossDPepper,987,278,709,-364.800000000001,0.281661600810537,0.7183383991894631
1019,TanDhesi,1444,547,897,-295.99999999999994,0.37880886426592797,0.621191135734072
1020,MarkVivis,361,181,180,-1.0000000000000004,0.5013850415512465,0.4986149584487535
1021,a_adeyemo,1280,418,862,-413.6000000000003,0.3265625,0.6734375
1022,julianknight15,2587,977,1610,-574.8000000000019,0.37765751836103595,0.622342481638964
1023,markblackburn,864,271,593,-290.0000000000002,0.3136574074074074,0.6863425925925926
1024,DJWarburton,1857,607,1250,-602.0000000000008,0.32687129779213786,0.6731287022078621
1025,reetenbanerji,124,31,93,-58.20000000000001,0.25,0.75
1026,Metcalfe_SBET,1282,473,809,-308.4000000000006,0.36895475819032764,0.6310452418096724
1027,heidiallen75,2495,763,1732,-901.9999999999987,0.30581162324649297,0.694188376753507
1028,DanGreef,1511,420,1091,-621.4000000000004,0.27796161482461945,0.7220383851753805
1029,susanvandeven,1400,516,884,-336.2000000000001,0.36857142857142855,0.6314285714285715
1030,LorraineJohnson,976,281,695,-374.00000000000034,0.28790983606557374,0.7120901639344263
1031,RobPearson_1,333,78,255,-162.6,0.23423423423423423,0.7657657657657657
1032,HeatherWheeler,340,147,193,-22.599999999999994,0.4323529411764706,0.5676470588235294
1033,LucyFrazerUK,156,70,86,-12.999999999999998,0.44871794871794873,0.5512820512820513
1034,HuwJonesLabour,2535,671,1864,-1109.9999999999998,0.26469428007889545,0.7353057199211045
1035,LNethsingha,1998,677,1321,-614.8000000000009,0.33883883883883886,0.6611611611611612
1036,Gareth4Labour,585,204,381,-161.80000000000004,0.3487179487179487,0.6512820512820513
1037,philhutty,462,139,323,-173.5999999999999,0.3008658008658009,0.6991341991341992
1038,sheryllmurray,839,342,497,-151.99999999999994,0.40762812872467225,0.5923718712753278
1039,juliacambridge1,1088,319,769,-421.6000000000006,0.2931985294117647,0.7068014705882353
1040,AlbertoCostaMP,1346,586,760,-161.8,0.43536404160475484,0.5646359583952452
1041,GPWebb,1628,522,1106,-535.2000000000012,0.32063882063882065,0.6793611793611793
1042,chrisj_brown,59,30,29,1.1999999999999993,0.5084745762711864,0.4915254237288136
1043,DanielleGlavin,404,133,271,-121.19999999999993,0.3292079207920792,0.6707920792079208
1044,bigeyedear,2410,850,1560,-633.2000000000021,0.35269709543568467,0.6473029045643154
1045,andrealeadsom,2297,1064,1233,-133.79999999999984,0.4632128863735307,0.5367871136264694
1046,SeemaKennedy,756,268,488,-196.99999999999994,0.3544973544973545,0.6455026455026455
1047,johnw129,2637,863,1774,-846.4000000000015,0.32726583238528634,0.6727341676147137
1048,GitanjaliG,1547,479,1068,-545.2000000000015,0.3096315449256626,0.6903684550743374
1049,EmmaLewellBuck,2474,876,1598,-660.0000000000013,0.35408245755860956,0.6459175424413904
1050,GavinWilliamson,225,109,116,-2.4000000000000004,0.48444444444444446,0.5155555555555555
1051,AndrewAAD,166,59,107,-44.0,0.35542168674698793,0.6445783132530121
1052,emmabishton,747,176,571,-352.60000000000053,0.23560910307898258,0.7643908969210174
1053,jc4southsuffolk,1181,462,719,-231.5999999999999,0.3911939034716342,0.6088060965283658
1054,RobertBuckland,2645,902,1743,-735.2000000000022,0.34102079395085066,0.6589792060491494
1055,StanPajak4MP,17,6,11,-5.3999999999999995,0.35294117647058826,0.6470588235294118
1056,Raushan4Labour,186,60,126,-62.6,0.3225806451612903,0.6774193548387096
1057,cmackinlay,1136,493,643,-137.9999999999999,0.4339788732394366,0.5660211267605634
1058,jordslw,538,129,409,-231.39999999999972,0.23977695167286245,0.7602230483271375
1059,DanielMNorton,805,289,516,-204.7999999999996,0.3590062111801242,0.6409937888198758
1060,AndrewSelous,178,81,97,-7.799999999999995,0.4550561797752809,0.5449438202247191
1061,DavidGauke,837,320,517,-181.0,0.3823178016726404,0.6176821983273596
1062,townsendchris,36,9,27,-16.4,0.25,0.75
1063,rob4sw_herts,72,25,47,-21.400000000000002,0.3472222222222222,0.6527777777777778
1064,Socialistsmithy,2709,907,1802,-841.4000000000011,0.3348098929494278,0.6651901070505721
1065,trussliz,554,248,306,-45.600000000000016,0.44765342960288806,0.5523465703971119
1066,labour4swsurrey,4,4,0,3.6,1.0,0.0
1067,Jeremy_Hunt,596,272,324,-47.79999999999999,0.4563758389261745,0.5436241610738255
1068,OlliePurkiss,123,51,72,-16.79999999999999,0.4146341463414634,0.5853658536585366
1069,trevorcarbin,181,19,162,-136.1999999999999,0.10497237569060773,0.8950276243093923
1070,AWMurrison,874,392,482,-68.79999999999991,0.448512585812357,0.551487414187643
1071,Laura_Pictor,521,178,343,-146.39999999999984,0.3416506717850288,0.6583493282149712
1072,EleanorBell2015,2813,954,1859,-839.400000000002,0.33913970849626734,0.6608602915037327
1073,SotonCityBoss,49,20,29,-9.799999999999999,0.40816326530612246,0.5918367346938775
1074,Royston_Smith,1199,463,736,-241.59999999999977,0.3861551292743953,0.6138448707256047
1075,ThomasGravatt,573,159,414,-239.39999999999995,0.2774869109947644,0.7225130890052356
1076,pauljholmes,590,183,407,-213.3999999999999,0.3101694915254237,0.6898305084745763
1077,alanwhiteheadmp,236,80,156,-73.4,0.3389830508474576,0.6610169491525424
1078,lucyvsalek,3019,1009,2010,-929.4000000000015,0.334216628022524,0.665783371977476
1079,warelane,3029,657,2372,-1612.1999999999944,0.21690326840541432,0.7830967315945857
1080,sue_mcguire,882,277,605,-277.39999999999964,0.31405895691609975,0.6859410430839002
1081,LizSavagelabour,998,239,759,-439.40000000000197,0.23947895791583165,0.7605210420841684
1082,SpelthorneLabPy,193,62,131,-58.40000000000002,0.32124352331606215,0.6787564766839378
1083,RosieShimell,9,7,2,3.8000000000000003,0.7777777777777778,0.2222222222222222
1084,libdemdaisy,1315,312,1003,-638.200000000001,0.23726235741444868,0.7627376425855513
1085,KerryPollard4mp,129,35,94,-54.800000000000004,0.2713178294573643,0.7286821705426356
1086,stevedouble,964,340,624,-255.3999999999998,0.35269709543568467,0.6473029045643154
1087,Kevin_4_Labour,74,9,65,-49.20000000000002,0.12162162162162163,0.8783783783783784
1088,ConorMcGinn,1193,522,671,-131.79999999999987,0.43755238893545684,0.5624476110645432
1089,ThomasMorrison,1116,292,824,-496.6000000000007,0.2616487455197133,0.7383512544802867
1090,jacksonngUK,310,123,187,-56.600000000000016,0.3967741935483871,0.603225806451613
1091,EdmcRandal,70,18,52,-29.800000000000008,0.2571428571428571,0.7428571428571429
1092,MarieRimmer,566,212,354,-126.39999999999989,0.3745583038869258,0.6254416961130742
1093,DerekThomasUK,204,82,122,-36.0,0.4019607843137255,0.5980392156862745
1094,JeremyLefroy,876,285,591,-298.7999999999997,0.3253424657534247,0.6746575342465754
1095,ctinker2,196,87,109,-16.799999999999997,0.44387755102040816,0.5561224489795918
1096,david4stafford,437,163,274,-98.19999999999989,0.37299771167048057,0.6270022883295194
1097,DaveMazzJones,377,123,254,-123.19999999999997,0.32625994694960214,0.6737400530503979
1098,Ankersman,2477,695,1782,-1011.6000000000004,0.280581348405329,0.719418651594671
1099,BG4MP,162,44,118,-66.00000000000003,0.2716049382716049,0.7283950617283951
1100,SMcPartland,419,194,225,-30.20000000000001,0.4630071599045346,0.5369928400954654
1101,wendyc4861,2504,883,1621,-671.0000000000015,0.3526357827476038,0.6473642172523961
1102,chriswkane,74,26,48,-20.2,0.35135135135135137,0.6486486486486487
1103,anncoffey_mp,541,228,313,-81.39999999999998,0.4214417744916821,0.5785582255083179
1104,danielrhamilton,2776,1047,1729,-629.800000000001,0.3771613832853026,0.6228386167146974
1105,danhaw426,1,0,1,-1.0,0.0,1.0
1106,ACunninghamMP,2830,986,1844,-793.0000000000013,0.3484098939929329,0.6515901060070671
1107,midroadpolitico,116,34,82,-44.2,0.29310344827586204,0.7068965517241379
1108,PaulWilliamsMP,164,53,111,-53.60000000000001,0.3231707317073171,0.676829268292683
1109,DanielJellyman,1172,444,728,-254.59999999999997,0.378839590443686,0.621160409556314
1110,benpolitics,1002,421,581,-140.19999999999982,0.42015968063872255,0.5798403193612774
1111,RuthSmeeth,1102,440,662,-199.19999999999993,0.3992740471869328,0.6007259528130672
1112,ToryPressMids,46,19,27,-7.0,0.41304347826086957,0.5869565217391305
1113,RobertFlello,1268,369,899,-497.000000000001,0.2910094637223975,0.7089905362776026
1114,nullibdems,156,40,116,-69.79999999999998,0.2564102564102564,0.7435897435897436
1115,BillCashMP,8,6,2,3.6,0.75,0.25
1116,ChrisBramall,1254,412,842,-408.00000000000017,0.32854864433811803,0.671451355661882
1117,margot_james_mp,1218,503,715,-178.19999999999982,0.4129720853858785,0.5870279146141215
1118,pete4stour,76,23,53,-28.200000000000003,0.3026315789473684,0.6973684210526315
1119,ClaireHiscott,654,306,348,-36.4,0.46788990825688076,0.5321100917431193
1120,Liz4Stratford,1969,624,1345,-667.6000000000006,0.3169121381411884,0.6830878618588115
1121,nadhimzahawi,2446,1013,1433,-374.6000000000012,0.4141455437448896,0.5858544562551103
1122,KimCaddy,9,3,6,-3.0,0.3333333333333333,0.6666666666666666
1123,sw16alex,587,198,389,-178.2,0.3373083475298126,0.6626916524701874
1124,ChukaUmunna,2471,803,1668,-797.2000000000008,0.32496964791582356,0.6750303520841765
1125,annacfryer,1897,630,1267,-587.0000000000009,0.33210332103321033,0.6678966789667896
1126,KateGreenSU,2501,858,1643,-721.8000000000026,0.343062774890044,0.656937225109956
1127,stroud_neil,2840,1292,1548,-211.99999999999946,0.45492957746478874,0.5450704225352113
1128,theresecoffey,2937,1026,1911,-812.8000000000022,0.34933605720122574,0.6506639427987743
1129,C4meronM4tthews,821,303,518,-203.39999999999998,0.3690621193666261,0.630937880633374
1130,james4suffolk,930,334,596,-240.39999999999995,0.35913978494623655,0.6408602150537634
1131,JulieElliottMP,1067,441,626,-163.19999999999976,0.4133083411433927,0.5866916588566073
1132,NiallHodson,413,152,261,-99.59999999999995,0.36803874092009686,0.6319612590799032
1133,robert_g_oliver,211,56,155,-90.0,0.26540284360189575,0.7345971563981043
1134,laweenatroshi,1947,745,1202,-439.4000000000004,0.38263995891114533,0.6173600410888547
1135,AnnMarie4SHeath,310,103,207,-96.99999999999993,0.33225806451612905,0.667741935483871
1136,RobPocock1,1273,436,837,-372.0000000000002,0.3424980361351139,0.6575019638648861
1137,amnajahmad,2115,721,1394,-615.6000000000013,0.3408983451536643,0.6591016548463356
1138,BonnieCraven,3038,937,2101,-1071.8000000000013,0.3084265964450296,0.6915734035549703
1139,scullyp,2965,894,2071,-1085.3999999999987,0.3015177065767285,0.6984822934232715
1140,DansBoucher,319,122,197,-66.0,0.3824451410658307,0.6175548589341693
1141,carolynharris24,2054,704,1350,-547.0000000000032,0.3427458617332035,0.6572541382667965
1142,CJRLawton,1556,423,1133,-668.8000000000017,0.2718508997429306,0.7281491002570694
1143,MikeEOCarroll,155,56,99,-40.99999999999999,0.36129032258064514,0.6387096774193548
1144,Andrew4Tamworth,391,126,265,-130.79999999999995,0.32225063938618925,0.6777493606138107
1145,ChrisPincher,1860,696,1164,-429.60000000000105,0.3741935483870968,0.6258064516129033
1146,EstherMcVey1,416,139,277,-117.99999999999983,0.33413461538461536,0.6658653846153846
1147,SamJRushworth,2469,778,1691,-841.0000000000023,0.3151073309031997,0.6848926690968004
1148,GarethLibDem,1679,523,1156,-570.4000000000017,0.31149493746277546,0.6885050625372245
1149,GideonJAmos,2603,900,1703,-746.2000000000005,0.3457548981943911,0.6542451018056089
1150,Martin4labour,29,10,19,-7.799999999999999,0.3448275862068966,0.6551724137931034
1151,pow_rebecca,1225,538,687,-126.59999999999994,0.43918367346938775,0.5608163265306122
1152,lucyallan,2728,931,1797,-797.2000000000013,0.3412756598240469,0.658724340175953
1153,Telfordlabour,1020,272,748,-443.2000000000007,0.26666666666666666,0.7333333333333333
1154,Kang4Labour,148,46,102,-48.60000000000002,0.3108108108108108,0.6891891891891891
1155,AndrewGant3,417,138,279,-123.79999999999988,0.33093525179856115,0.6690647482014388
1156,markhubandcots,107,32,75,-38.40000000000001,0.29906542056074764,0.7009345794392523
1157,MPritchardUK,637,328,309,20.000000000000032,0.5149136577708007,0.4850863422291994
1158,AveryforLabour,9,2,7,-5.0,0.2222222222222222,0.7777777777777778
1159,kevinhollinrake,1890,636,1254,-570.8000000000017,0.33650793650793653,0.6634920634920635
1160,dinahkeal,1382,455,927,-404.0000000000009,0.329232995658466,0.670767004341534
1161,ClaireforTAY,1169,333,836,-479.60000000000065,0.2848588537211292,0.7151411462788708
1162,JackieDP,679,211,468,-245.20000000000005,0.31075110456553756,0.6892488954344624
1163,TheJohnKent,486,150,336,-174.79999999999998,0.30864197530864196,0.691358024691358
1164,CarolineKolek,2752,896,1856,-854.4000000000028,0.32558139534883723,0.6744186046511628
1165,neil_parish,837,323,514,-175.59999999999985,0.3859020310633214,0.6140979689366786
1166,TomTugendhat,2683,1001,1682,-612.2000000000007,0.3730898248229594,0.6269101751770406
1167,DrRosena,2585,1054,1531,-417.60000000000144,0.40773694390715665,0.5922630560928434
1168,AlexGlassbrook,501,183,318,-119.99999999999994,0.3652694610778443,0.6347305389221557
1169,DanWatkins,2021,778,1243,-426.80000000000103,0.38495794161306285,0.6150420583869372
1170,Deborah4Torbay,171,67,104,-36.79999999999997,0.391812865497076,0.6081871345029239
1171,kevin_j_foster,2884,899,1985,-1035.3999999999999,0.31171983356449373,0.6882801664355063
1172,NickTorfaenMP,2019,770,1249,-418.40000000000185,0.3813769192669638,0.6186230807330362
1173,chalmersdavidn,2879,1070,1809,-680.4000000000029,0.37165682528655786,0.6283431747134421
1174,Geoffrey_Cox,213,93,120,-22.999999999999996,0.43661971830985913,0.5633802816901409
1175,sarahwollaston,1659,567,1092,-502.4000000000012,0.34177215189873417,0.6582278481012658
1176,DavidLammy,2658,919,1739,-744.4000000000004,0.34574868322046654,0.6542513167795335
1177,JayneKirkham4,228,59,169,-102.99999999999993,0.25877192982456143,0.7412280701754386
1178,SNewtonUK,523,232,291,-50.40000000000002,0.4435946462715105,0.5564053537284895
1179,GregClarkMP,125,58,67,-5.6000000000000005,0.464,0.536
1180,RachelSadlerTW,2632,845,1787,-866.0000000000014,0.321048632218845,0.6789513677811551
1181,vincecable,727,214,513,-281.8,0.29436038514442914,0.7056396148555708
1182,katherinedunne,1949,621,1328,-643.4000000000017,0.31862493586454593,0.6813750641354541
1183,tania_mathias,898,395,503,-85.19999999999995,0.4398663697104677,0.5601336302895323
1184,alancampbellmp,254,136,118,21.399999999999995,0.5354330708661418,0.4645669291338583
1185,BorisJohnson,670,331,339,-5.799999999999998,0.49402985074626865,0.5059701492537313
1186,VincentLoUK,140,53,87,-27.600000000000012,0.37857142857142856,0.6214285714285714
1187,RosinaRobson,421,133,288,-141.79999999999995,0.3159144893111639,0.684085510688836
1188,JamesDavies,786,294,492,-175.19999999999985,0.37404580152671757,0.6259541984732825
1189,ChrisRuane2017,77,26,51,-24.0,0.33766233766233766,0.6623376623376623
1190,wgwynwilliams,156,40,116,-67.6,0.2564102564102564,0.7435897435897436
1191,AlunCairns,1683,757,926,-133.19999999999987,0.44979203802733214,0.5502079619726679
1192,KateHoeyMP,1365,554,811,-249.79999999999959,0.40586080586080586,0.5941391941391941
1193,dollytheis,1792,725,1067,-300.20000000000044,0.40457589285714285,0.5954241071428571
1194,georgenturner,2864,731,2133,-1332.799999999999,0.25523743016759776,0.7447625698324022
1195,antony_calvert,1610,470,1140,-618.6000000000009,0.2919254658385093,0.7080745341614907
1196,MaryCreaghMP,2887,975,1912,-852.2000000000028,0.33772081745756843,0.6622791825424316
1197,LiverLibDems,947,309,638,-292.00000000000017,0.3262935586061246,0.6737064413938754
1198,angelaeagle,2868,910,1958,-970.0000000000023,0.3172942817294282,0.6827057182705718
1199,greycoatlaw,894,333,561,-198.1999999999997,0.3724832214765101,0.62751677852349
1200,James_Bird_,97,37,60,-22.8,0.38144329896907214,0.6185567010309279
1201,anrawel,31,5,26,-20.400000000000002,0.16129032258064516,0.8387096774193549
1202,Valerie_VazMP,1473,545,928,-340.00000000000034,0.3699932111337407,0.6300067888662594
1203,AlDanka,367,102,265,-149.79999999999993,0.2779291553133515,0.7220708446866485
1204,Molly4Wstow,833,268,565,-218.59999999999928,0.3217286914765906,0.6782713085234093
1205,IanLaveryMP,341,159,182,-19.600000000000012,0.4662756598240469,0.533724340175953
1206,Chris_Carrigan1,26,7,19,-10.399999999999999,0.2692307692307692,0.7307692307692307
1207,edvaizey,2356,1012,1344,-261.9999999999998,0.4295415959252971,0.5704584040747029
1208,AnthonyMangnal1,29,14,15,-1.1999999999999995,0.4827586206896552,0.5172413793103449
1209,spellar,2795,806,1989,-1106.000000000002,0.28837209302325584,0.7116279069767442
1210,HelenJonesMP,1505,571,934,-332.40000000000055,0.37940199335548175,0.6205980066445183
1211,canazirk,1202,372,830,-432.60000000000014,0.30948419301164726,0.6905158069883528
1212,CllrBobBarr,1841,585,1256,-618.0000000000007,0.3177620858229223,0.6822379141770777
1213,FaisalRashid6,1033,315,718,-298.4000000000006,0.30493707647628265,0.6950629235237173
1214,MattWestern_,1225,414,811,-351.60000000000014,0.3379591836734694,0.6620408163265306
1215,Chris_White_67,650,251,399,-129.39999999999986,0.3861538461538462,0.6138461538461538
1216,JEGullis,2629,1087,1542,-415.2000000000012,0.4134651958919741,0.5865348041080258
1217,SharonHodgsonMP,2169,802,1367,-513.6000000000021,0.36975564776394654,0.6302443522360535
1218,Richard4Watford,425,156,269,-100.39999999999992,0.36705882352941177,0.6329411764705882
1219,ianstotesbury,1380,515,865,-311.6000000000005,0.37318840579710144,0.6268115942028986
1220,peter_aldous,316,125,191,-61.000000000000036,0.39556962025316456,0.6044303797468354
1221,sunrisesonj,1675,587,1088,-463.4000000000008,0.35044776119402987,0.6495522388059701
1222,JackyAnnH1,35,7,28,-20.0,0.2,0.8
1223,chris1bowers,76,37,39,-0.9999999999999989,0.4868421052631579,0.5131578947368421
1224,Nus_Ghani,2654,1134,1520,-327.40000000000146,0.4272795779954785,0.5727204220045214
1225,angie4wealden,59,19,40,-21.0,0.3220338983050847,0.6779661016949152
1226,MikeAmesbury,2626,919,1707,-716.2000000000025,0.34996191926884995,0.65003808073115
1227,GrahamEvans,3177,1193,1984,-711.8000000000011,0.37551148882593643,0.6244885111740636
1228,PeterBoneUK,523,216,307,-77.79999999999997,0.4130019120458891,0.5869980879541109
1229,chris_nelson,241,81,160,-69.00000000000003,0.3360995850622407,0.6639004149377593
1230,voteandreawatts,367,109,258,-138.3999999999999,0.2970027247956403,0.7029972752043597
1231,JSHeappey,909,335,574,-206.5999999999998,0.36853685368536854,0.6314631463146315
1232,wellsmp,175,72,103,-28.000000000000004,0.4114285714285714,0.5885714285714285
1233,tessamunt,683,215,468,-233.79999999999993,0.31478770131771594,0.6852122986822841
1234,WHLabour,181,44,137,-74.39999999999999,0.2430939226519337,0.7569060773480663
1235,NigelQuinton,676,227,449,-202.3999999999999,0.33579881656804733,0.6642011834319527
1236,grantshapps,497,170,327,-143.99999999999997,0.3420523138832998,0.6579476861167002
1237,JohnHealey_MP,1163,419,744,-287.2000000000002,0.36027515047291486,0.6397248495270851
1238,JohnRWaddell,2953,858,2095,-1153.7999999999984,0.29055198103623436,0.7094480189637656
1239,EmmaCrane2017,89,37,52,-13.0,0.4157303370786517,0.5842696629213483
1240,tom_watson,2932,885,2047,-1059.0,0.3018417462482947,0.6981582537517054
1241,FloClucas,2708,925,1783,-792.400000000002,0.34158050221565733,0.6584194977843427
1242,oletwinofficial,36,13,23,-10.200000000000001,0.3611111111111111,0.6388888888888888
1243,jeananneforWD,600,164,436,-255.39999999999998,0.2733333333333333,0.7266666666666667
1244,R_Plenderleith,2893,677,2216,-1447.7999999999945,0.23401313515381955,0.7659868648461804
1245,lynbrownmp,2299,714,1585,-788.8000000000015,0.31056981296215747,0.6894301870378425
1246,pspencer88,1430,491,939,-423.2000000000002,0.34335664335664334,0.6566433566433566
1247,CllrJoBarton,10,2,8,-5.8,0.2,0.8
1248,rosie4westlancs,525,189,336,-142.59999999999997,0.36,0.64
1249,Samuel_P_Currie,306,74,232,-147.19999999999993,0.24183006535947713,0.7581699346405228
1250,MattHancock,2757,1302,1455,-82.39999999999974,0.4722524483133841,0.5277475516866159
1251,Cllr_M_Jefferys,25,4,21,-16.4,0.16,0.84
1252,hbaldwin,2433,907,1526,-569.2000000000012,0.3727907932593506,0.6272092067406494
1253,emcmillanscott,2301,761,1540,-721.2000000000025,0.3307257714037375,0.6692742285962625
1254,KarenPBuckMP,2582,826,1756,-849.2000000000005,0.3199070487993803,0.6800929512006196
1255,Lindsey4WNorth,103,63,40,24.0,0.6116504854368932,0.3883495145631068
1256,alexandharding,72,25,47,-20.6,0.3472222222222222,0.6527777777777778
1257,James4WandL,2266,822,1444,-576.0000000000017,0.3627537511032657,0.6372462488967343
1258,EliAldridge,2883,812,2071,-1151.1999999999982,0.2816510579257718,0.7183489420742283
1259,timfarron,3103,886,2217,-1271.7999999999977,0.28553013213019657,0.7144698678698034
1260,ldmikebell,1253,438,815,-339.4000000000004,0.349561053471668,0.650438946528332
1261,JohnPenroseNews,710,260,450,-171.7999999999999,0.36619718309859156,0.6338028169014085
1262,TimTaylorWeston,71,25,46,-19.4,0.352112676056338,0.647887323943662
1263,lisanandy,869,318,551,-211.79999999999995,0.3659378596087457,0.6340621403912543
1264,AlexWilliams175,699,243,456,-195.9999999999998,0.34763948497854075,0.6523605150214592
1265,S_Hammond,2282,729,1553,-769.3999999999997,0.3194566170026293,0.6805433829973707
1266,carlquilliam,1212,401,811,-378.20000000000067,0.33085808580858084,0.6691419141914191
1267,ImranUddin2003,284,103,181,-66.6,0.3626760563380282,0.6373239436619719
1268,LabourChaloner,4,3,1,1.6,0.75,0.25
1269,jackielibdem,393,155,238,-77.40000000000005,0.3944020356234097,0.6055979643765903
1270,AdamAfriyie,247,131,116,18.199999999999996,0.5303643724696356,0.46963562753036436
1271,PeterLShearman,122,31,91,-54.6,0.2540983606557377,0.7459016393442623
1272,cllrccarubia,1751,486,1265,-721.6000000000012,0.2775556824671616,0.7224443175328383
1273,Alison_McGovern,2718,819,1899,-980.2000000000022,0.30132450331125826,0.6986754966887417
1274,AdamSykesWirral,1249,355,894,-485.6000000000015,0.28422738190552443,0.7157726180944756
1275,MGreenwoodWW,2923,958,1965,-913.8000000000011,0.3277454669859733,0.6722545330140267
1276,BWLabour,430,132,298,-153.3999999999999,0.30697674418604654,0.6930232558139535
1277,JoHayesLibDem,2825,870,1955,-1000.6000000000021,0.30796460176991153,0.6920353982300885
1278,laetisiacarter,1121,398,723,-294.20000000000016,0.35504014272970563,0.6449598572702944
1279,robertcourts,1666,729,937,-173.0,0.4375750300120048,0.5624249699879952
1280,lizleffman,300,99,201,-92.59999999999995,0.33,0.67
1281,FionaColley,348,103,245,-131.99999999999991,0.2959770114942529,0.7040229885057471
1282,WillForster,956,263,693,-404.8000000000003,0.27510460251046026,0.7248953974895398
1283,AndyCroy,1797,524,1273,-694.4000000000011,0.2915971062882582,0.7084028937117418
1284,CllrCliveJones,443,142,301,-146.99999999999997,0.32054176072234764,0.6794582392776524
1285,johnredwood,1294,420,874,-452.00000000000017,0.32457496136012365,0.6754250386398764
1286,EmmaReynoldsMP,1576,628,948,-303.4000000000001,0.39847715736040606,0.6015228426395939
1287,binny_uk,2550,594,1956,-1252.399999999997,0.23294117647058823,0.7670588235294118
1288,patmcfaddenmp,1970,815,1155,-304.2000000000005,0.4137055837563452,0.5862944162436549
1289,KieranMullanUK,7,3,4,-1.2,0.42857142857142855,0.5714285714285714
1290,Alibdem,295,99,196,-91.19999999999999,0.33559322033898303,0.6644067796610169
1291,stephenakearney,123,47,76,-25.400000000000013,0.3821138211382114,0.6178861788617886
1292,JoySquires,982,422,560,-110.5999999999998,0.42973523421588594,0.570264765784114
1293,WalkerWorcester,2841,1268,1573,-266.00000000000006,0.4463217177050334,0.5536782822949665
1294,SueHayman1,1586,543,1043,-476.40000000000094,0.34237074401008827,0.6576292559899117
1295,phillroberts2,5,1,4,-2.6,0.2,0.8
1296,ClarkVasey,1209,496,713,-200.59999999999988,0.41025641025641024,0.5897435897435898
1297,KeeleyMP,2068,712,1356,-592.600000000001,0.344294003868472,0.655705996131528
1298,cllrilindley,2775,899,1876,-902.6000000000007,0.323963963963964,0.676036036036036
1299,hazel_thorpe,2844,946,1898,-890.4000000000008,0.33263009845288327,0.6673699015471167
1300,andrew4wrexham,2810,1065,1745,-591.4000000000026,0.3790035587188612,0.6209964412811388
1301,IanCLucas,2849,1017,1832,-761.0000000000007,0.356967356967357,0.6430326430326431
1302,SteveBakerHW,2910,1091,1819,-673.2000000000011,0.37491408934707904,0.625085910652921
1303,stevekguy,118,32,86,-50.6,0.2711864406779661,0.7288135593220338
1304,WycombeLabour,50,17,33,-12.8,0.34,0.66
1305,Mark4WyreForest,1352,628,724,-83.19999999999996,0.46449704142011833,0.5355029585798816
1306,Matt4wyreforest,5,2,3,-1.4,0.4,0.6
1307,Michelle4WPN,148,53,95,-38.6,0.3581081081081081,0.6418918918918919
1308,johnpotterLD,1182,361,821,-431.60000000000053,0.305414551607445,0.694585448392555
1309,BWallaceMP,832,286,546,-237.79999999999967,0.34375,0.65625
1310,Fiona20Green,41,8,33,-22.4,0.1951219512195122,0.8048780487804879
1311,MikeKaneMP,1555,611,944,-321.40000000000026,0.3929260450160772,0.6070739549839228
1312,MarcusFysh,2297,972,1325,-338.4,0.42316064431867656,0.5768393556813235
1313,AlbertOwenMP,2676,1036,1640,-540.8000000000014,0.38714499252615847,0.6128550074738416
1314,NickLovesYork,1049,381,668,-270.79999999999995,0.36320305052430885,0.6367969494756911
1315,jamesblanchard,207,55,152,-92.0,0.26570048309178745,0.7342995169082126
