,twitter_username,tweets_count,postive,negative,sum_sentiment,postive_r,negative_r
1,Helenceri,22,3,19,-13.8,0.13636363636363635,0.8636363636363636
2,Edward4East,633,224,409,-165.5999999999999,0.353870458135861,0.6461295418641391
3,Bathula_Victor,2,1,1,0.0,0.5,0.5
4,euandavidson,1868,565,1303,-682.8000000000018,0.3024625267665953,0.6975374732334048
5,annebegg,1139,400,739,-314.00000000000006,0.35118525021949076,0.6488147497805092
6,RDJRixson,86,17,69,-48.60000000000001,0.19767441860465115,0.8023255813953488
7,alanhilliar,9,4,5,-0.40000000000000013,0.4444444444444444,0.5555555555555556
8,geraldhowarth,365,140,225,-76.19999999999993,0.3835616438356164,0.6164383561643836
9,JohnFisher_1,286,95,191,-87.6,0.3321678321678322,0.6678321678321678
10,ablibdems,319,110,209,-87.6,0.3448275862068966,0.6551724137931034
11,morton_wendy,476,194,282,-78.00000000000001,0.40756302521008403,0.592436974789916
12,JTudorJones,159,45,114,-64.00000000000001,0.2830188679245283,0.7169811320754716
13,lauraknightly,572,203,369,-155.39999999999992,0.3548951048951049,0.6451048951048951
14,MarkTamiMP,262,77,185,-103.79999999999997,0.29389312977099236,0.7061068702290076
15,KevinGillottDCC,209,78,131,-44.80000000000001,0.37320574162679426,0.6267942583732058
16,KateSmithLibDem,30,13,17,-3.2,0.43333333333333335,0.5666666666666667
17,gerardmcmahon86,1071,337,734,-368.2000000000007,0.3146591970121382,0.6853408029878618
18,Anwen4Arfon,104,33,71,-31.60000000000002,0.3173076923076923,0.6826923076923077
19,AlanReidAandB,49,9,40,-28.200000000000006,0.1836734693877551,0.8163265306122449
20,nickherbertmp,1387,513,874,-326.59999999999997,0.3698630136986301,0.6301369863013698
21,cllrwellbelove,1618,447,1171,-665.0000000000013,0.2762669962917182,0.7237330037082819
22,helenharrisonuk,332,129,203,-65.79999999999995,0.3885542168674699,0.6114457831325302
23,BrendanChilton,701,210,491,-251.39999999999986,0.2995720399429387,0.7004279600570613
24,DamianGreen,1293,475,818,-313.20000000000016,0.36736272235112144,0.6326372776488786
25,cm_hicks,396,126,270,-129.5999999999999,0.3181818181818182,0.6818181818181818
26,stevenlambert1,2456,741,1715,-898.4000000000005,0.30171009771986973,0.6982899022801303
27,VictoriaPrentis,110,51,59,-8.2,0.4636363636363636,0.5363636363636364
28,margarethodge,877,288,589,-287.0000000000003,0.32839224629418473,0.6716077537058153
29,MinaRahman1,1140,434,706,-242.1999999999997,0.38070175438596493,0.6192982456140351
30,DanJarvisMP,991,343,648,-270.00000000000006,0.34611503531786075,0.6538849646821393
31,DavidRidgway67,384,151,233,-72.19999999999996,0.3932291666666667,0.6067708333333334
32,simonfell,780,223,557,-306.6000000000001,0.2858974358974359,0.7141025641025641
33,CllrPaulHarvey,1005,352,653,-277.40000000000003,0.3502487562189055,0.6497512437810945
34,LD4Bassetlaw,557,153,404,-234.00000000000006,0.2746858168761221,0.725314183123878
35,JohnMannMP,131,37,94,-53.6,0.2824427480916031,0.7175572519083969
36,Ollie_Middleton,1716,512,1204,-638.4000000000012,0.29836829836829837,0.7016317016317016
37,imtiazameen,903,294,609,-296.1999999999999,0.32558139534883723,0.6744186046511628
38,JaneEllison,1281,639,642,9.40000000000001,0.49882903981264637,0.5011709601873536
39,WillJMartindale,2154,773,1381,-543.4000000000012,0.35886722376973074,0.6411327762302693
40,LukeTaylor104,457,137,320,-174.00000000000006,0.29978118161925604,0.700218818380744
41,BeaconsfieldLab,211,70,141,-66.4,0.33175355450236965,0.6682464454976303
42,AnujaPrashar,1098,459,639,-164.19999999999993,0.4180327868852459,0.5819672131147541
43,MahmudHenryR,82,24,58,-35.8,0.2926829268292683,0.7073170731707317
44,Manton4Belfast,3,0,3,-3.0,0.0,1.0
45,Shea4WestBel,198,69,129,-52.40000000000002,0.3484848484848485,0.6515151515151515
46,jpfloru,490,157,333,-158.39999999999975,0.32040816326530613,0.6795918367346939
47,ScottDickinson0,2044,624,1420,-718.4000000000016,0.30528375733855184,0.6947162426614482
48,John2Win,1352,491,861,-340.4000000000004,0.3631656804733728,0.6368343195266272
49,kenryckbell,742,251,491,-210.19999999999996,0.33827493261455527,0.6617250673854448
50,rushanaraali,585,219,366,-134.59999999999988,0.37435897435897436,0.6256410256410256
51,denishealy,6,0,6,-3.6,0.0,1.0
52,grahamstuart,1893,725,1168,-407.6000000000009,0.3829899630216587,0.6170100369783412
53,HuwMerriman,152,73,79,-3.599999999999997,0.48026315789473684,0.5197368421052632
54,StefBorella,59,14,45,-29.200000000000003,0.23728813559322035,0.7627118644067796
55,DrDickyD,2144,848,1296,-405.6000000000008,0.39552238805970147,0.6044776119402985
56,DavidEvennett,46,11,35,-24.2,0.2391304347826087,0.7608695652173914
57,AllanBrame,66,20,46,-24.8,0.30303030303030304,0.696969696969697
58,frankfieldteam,241,77,164,-80.39999999999999,0.31950207468879666,0.6804979253112033
59,drlukeevans,1165,424,741,-288.6000000000003,0.36394849785407724,0.6360515021459228
60,GiselaStuart,1163,379,784,-370.20000000000044,0.32588134135855545,0.6741186586414445
61,RogerGodsiff,451,139,312,-166.60000000000005,0.3082039911308204,0.6917960088691796
62,PhilBennionMEP,2396,920,1476,-528.2000000000005,0.38397328881469117,0.6160267111853088
63,KieranMullanUK,25,8,17,-9.6,0.32,0.68
64,ShabanaMahmood,933,335,598,-240.60000000000002,0.3590568060021436,0.6409431939978564
65,IsabelSigmac,504,206,298,-71.40000000000002,0.4087301587301587,0.5912698412698413
66,Centreradical,1797,451,1346,-843.2000000000015,0.25097384529771843,0.7490261547022816
67,ch4pb,350,111,239,-113.39999999999995,0.3171428571428571,0.6828571428571428
68,khalid4PB,25,6,19,-11.600000000000001,0.24,0.76
69,alex_boulter,217,90,127,-35.20000000000002,0.4147465437788018,0.5852534562211982
70,ColinGreenLD,1786,503,1283,-739.0000000000009,0.28163493840985443,0.7183650615901456
71,johnhemming4mp,904,225,679,-443.20000000000033,0.2488938053097345,0.7511061946902655
72,APhotay,353,139,214,-64.59999999999998,0.3937677053824363,0.6062322946175638
73,C_F_Adams,242,67,175,-100.2,0.2768595041322314,0.7231404958677686
74,Bobrjeastwood,2601,918,1683,-662.0000000000022,0.35294117647058826,0.6470588235294118
75,Kate_HollernMP,1418,489,929,-420.80000000000047,0.344851904090268,0.655148095909732
76,michtanfield,1176,377,799,-392.2000000000006,0.320578231292517,0.6794217687074829
77,PaulMaynardUK,1897,651,1246,-543.2000000000011,0.34317343173431736,0.6568265682656826
78,peterfor2017,1265,482,783,-241.79999999999941,0.38102766798418974,0.6189723320158103
79,SamuelEllisRees,2718,696,2022,-1259.9999999999989,0.2560706401766004,0.7439293598233996
80,traceymwest,107,23,84,-56.2,0.21495327102803738,0.7850467289719626
81,DaveAndersonMP,274,102,172,-61.400000000000006,0.3722627737226277,0.6277372262773723
82,BVLabour,185,53,132,-64.20000000000005,0.2864864864864865,0.7135135135135136
83,PhilipLatham,81,26,55,-28.200000000000003,0.32098765432098764,0.6790123456790124
84,Greg_A_Munro,77,20,57,-33.800000000000004,0.2597402597402597,0.7402597402597403
85,atbutcher,1245,204,1041,-657.0000000000049,0.163855421686747,0.8361445783132531
86,NickGibbUK,3,0,3,-3.0,0.0,1.0
87,FrancisOppler,13,5,8,-2.8000000000000003,0.38461538461538464,0.6153846153846154
88,DavidCrausby,188,49,139,-81.6,0.26063829787234044,0.7393617021276596
89,cllrjamesdaly,2138,1000,1138,-104.39999999999972,0.4677268475210477,0.5322731524789522
90,YasminQureshiMP,1342,500,842,-317.0000000000006,0.37257824143070045,0.6274217585692996
91,Peter_Dowd,1258,439,819,-354.80000000000024,0.34896661367249604,0.651033386327504
92,jade4bootle,24,5,19,-11.999999999999998,0.20833333333333334,0.7916666666666666
93,paul_r_kenny,1206,376,830,-418.60000000000076,0.3117744610281924,0.6882255389718076
94,DavidWatts12,284,69,215,-137.59999999999997,0.24295774647887325,0.7570422535211268
95,_ChrisKealey,1060,361,699,-307.80000000000007,0.34056603773584904,0.659433962264151
96,Tobias_Ellwood,691,335,356,-24.19999999999998,0.48480463096960924,0.5151953690303908
97,ConorBurnsUK,2130,750,1380,-580.0000000000007,0.352112676056338,0.647887323943662
98,dave4bmthwest,164,70,94,-20.800000000000004,0.4268292682926829,0.573170731707317
99,DrPhillipLeeMP,1357,520,837,-294.8000000000001,0.3831982313927782,0.6168017686072218
100,PatrickSmithLD,369,116,253,-127.99999999999996,0.3143631436314363,0.6856368563685636
101,JamesLWalsh,981,306,675,-342.40000000000026,0.3119266055045872,0.6880733944954128
102,iftikharBE1,269,89,180,-78.59999999999997,0.3308550185873606,0.6691449814126395
103,Imran_HussainMP,104,43,61,-16.4,0.41346153846153844,0.5865384615384616
104,DWard,2003,595,1408,-768.6000000000013,0.29705441837244134,0.7029455816275587
105,JudithCummins,797,306,491,-161.3999999999999,0.383939774153074,0.616060225846926
106,GeorgePBGrant,1144,375,769,-364.4000000000006,0.3277972027972028,0.6722027972027972
107,mtklesel,142,28,114,-78.99999999999997,0.19718309859154928,0.8028169014084507
108,MatthewDorrance,2061,623,1438,-751.200000000001,0.30228044638524987,0.6977195536147501
109,RogerWilliamsLD,1702,576,1126,-502.2000000000013,0.3384253819036428,0.6615746180963572
110,laurenpk,755,233,522,-276.79999999999995,0.3086092715231788,0.6913907284768211
111,AlanMPolitics,562,203,359,-151.40000000000003,0.3612099644128114,0.6387900355871886
112,BarryGardiner,55,17,38,-20.8,0.3090909090909091,0.6909090909090909
113,luke_r_parker,186,72,114,-29.00000000000002,0.3870967741935484,0.6129032258064516
114,JosephBourke,1407,355,1052,-621.6000000000021,0.2523098791755508,0.7476901208244492
115,MaryMacleodUK,1698,736,962,-181.19999999999973,0.4334511189634865,0.5665488810365136
116,lbpreston,688,252,436,-167.20000000000005,0.36627906976744184,0.6337209302325582
117,Cisntbelieving,42,11,31,-18.8,0.2619047619047619,0.7380952380952381
118,meirionj,208,58,150,-88.4,0.27884615384615385,0.7211538461538461
119,MadeleineMoon,973,382,591,-187.39999999999986,0.3926002055498458,0.6073997944501541
120,micklerry,1024,306,718,-394.0000000000005,0.298828125,0.701171875
121,TheoButtPhilip,1038,267,771,-471.40000000000117,0.25722543352601157,0.7427745664739884
122,lizleffman,7,1,6,-5.0,0.14285714285714285,0.8571428571428571
123,thepaulchandler,107,28,79,-48.800000000000004,0.2616822429906542,0.7383177570093458
124,chris1bowers,80,35,45,-7.0,0.4375,0.5625
125,mitch_1uk,2029,805,1224,-381.4000000000002,0.39674716609167077,0.6032528339083292
126,Purna_Sen,2460,861,1599,-668.2000000000014,0.35,0.65
127,theodoraclarke,1163,512,651,-110.99999999999974,0.4402407566638005,0.5597592433361995
128,ClareCCS,3,2,1,0.6,0.6666666666666666,0.3333333333333333
129,darrenpjones,1509,467,1042,-533.6000000000012,0.30947647448641485,0.6905235255135852
130,CharlotteLeslie,225,81,144,-55.79999999999996,0.36,0.64
131,isogrant,649,252,397,-124.59999999999991,0.3882896764252696,0.6117103235747303
132,ClaireHiscott,1674,645,1029,-337.60000000000014,0.38530465949820786,0.6146953405017921
133,Chris4NorwichN,11,3,8,-5.2,0.2727272727272727,0.7272727272727273
134,john72442541,91,30,61,-31.4,0.32967032967032966,0.6703296703296703
135,tomebbutt,2182,681,1501,-746.8000000000021,0.31209899175068745,0.6879010082493126
136,sajidjavid,717,301,416,-95.79999999999983,0.4198047419804742,0.5801952580195258
137,ejcrobinson,245,84,161,-69.8,0.34285714285714286,0.6571428571428571
138,stanheptinstall,473,257,216,39.59999999999999,0.5433403805496829,0.45665961945031713
139,Nick4Broxtowe,622,202,420,-204.5999999999999,0.3247588424437299,0.6752411575562701
140,GBirtwistle,615,239,376,-126.3999999999999,0.3886178861788618,0.6113821138211382
141,SCockburnPrice,528,194,334,-131.79999999999993,0.36742424242424243,0.6325757575757576
142,JulieForBurnley,1196,379,817,-409.2000000000003,0.3168896321070234,0.6831103678929766
143,AndrewGriffiths,277,95,182,-80.2,0.34296028880866425,0.6570397111913358
144,DJMac1986,921,307,614,-277.4000000000002,0.3333333333333333,0.6666666666666666
145,JonWheale,2458,957,1501,-446.2000000000023,0.38934092758340116,0.6106590724165989
146,richardbaum,303,96,207,-99.59999999999995,0.31683168316831684,0.6831683168316832
147,BuryNorthLabour,28,18,10,8.0,0.6428571428571429,0.35714285714285715
148,DNuttall,883,329,554,-214.5999999999998,0.3725934314835787,0.6274065685164213
149,IvanLewis_MP,820,363,457,-89.19999999999992,0.4426829268292683,0.5573170731707318
150,xdavidchappell,399,130,269,-134.79999999999995,0.3258145363408521,0.6741854636591479
151,Jochurchill4,405,171,234,-55.2,0.4222222222222222,0.5777777777777777
152,billburysted,8,2,6,-3.2,0.25,0.75
153,WayneDavid_MP,914,393,521,-107.5999999999999,0.4299781181619256,0.5700218818380745
154,LeoDochertyUK,195,72,123,-44.40000000000001,0.36923076923076925,0.6307692307692307
155,johnerskine,803,236,567,-305.40000000000026,0.29389788293897884,0.7061021170610212
156,AGrahamCSER,134,42,92,-44.800000000000004,0.31343283582089554,0.6865671641791045
157,HarrietHarman,675,197,478,-255.39999999999975,0.29185185185185186,0.7081481481481482
158,NaomiNewstead,299,113,186,-63.800000000000004,0.3779264214046823,0.6220735785953178
159,jgoldsworthy,656,237,419,-162.39999999999984,0.36128048780487804,0.6387195121951219
160,amandamilling,321,109,212,-98.59999999999997,0.3395638629283489,0.660436137071651
161,JanosToth1,1021,268,753,-464.0000000000005,0.2624877571008815,0.7375122428991185
162,JamesCanterbury,972,355,617,-234.99999999999991,0.36522633744855965,0.6347736625514403
163,JennyWillott,1666,543,1123,-519.8000000000019,0.32593037214885956,0.6740696278511404
164,ElizabethCdf,46,15,31,-14.6,0.32608695652173914,0.6739130434782609
165,Mari_Williams,2445,865,1580,-633.6000000000023,0.3537832310838446,0.6462167689161554
166,NigelHowellsCdf,338,111,227,-115.59999999999995,0.32840236686390534,0.6715976331360947
167,EmmaWarman,481,185,296,-101.6,0.38461538461538464,0.6153846153846154
168,JTaghdissian,87,26,61,-32.8,0.2988505747126437,0.7011494252873564
169,CadanapTomos,238,74,164,-84.79999999999998,0.31092436974789917,0.6890756302521008
170,LoraineBirchall,13,8,5,3.0,0.6153846153846154,0.38461538461538464
171,MissleeCarlisle,877,315,562,-215.79999999999993,0.35917901938426455,0.6408209806157354
172,John4Carlisle,184,69,115,-48.199999999999996,0.375,0.625
173,calumhiggins,1861,631,1230,-540.8000000000013,0.33906501880709294,0.6609349811929071
174,delyth_evans,528,241,287,-36.60000000000001,0.4564393939393939,0.5435606060606061
175,Simonhartmp,843,329,514,-156.40000000000003,0.3902728351126928,0.6097271648873073
176,SelwynRunnett,1250,424,826,-355.00000000000057,0.3392,0.6608
177,mmaxwellscott,1090,318,772,-409.40000000000066,0.29174311926605506,0.708256880733945
178,siobhan4candw,396,133,263,-117.19999999999989,0.33585858585858586,0.6641414141414141
179,JoeCookeLabour,284,84,200,-107.99999999999996,0.29577464788732394,0.704225352112676
180,GordonBain,604,205,399,-178.59999999999994,0.3394039735099338,0.6605960264900662
181,Lynne__Richards,516,171,345,-165.39999999999992,0.3313953488372093,0.6686046511627907
182,alexjwhiteld,437,136,301,-155.39999999999995,0.3112128146453089,0.6887871853546911
183,jackabbott90,1742,557,1185,-560.200000000001,0.31974741676234214,0.6802525832376579
184,jonneal_UK,554,168,386,-202.1999999999999,0.30324909747292417,0.6967509025270758
185,drdanpoulter,596,268,328,-43.40000000000003,0.44966442953020136,0.5503355704697986
186,hhensher,108,41,67,-26.999999999999996,0.37962962962962965,0.6203703703703703
187,huwthomas_Wales,1135,395,740,-309.40000000000003,0.34801762114537443,0.6519823788546255
188,mark4ceredigion,1467,540,927,-356.80000000000047,0.36809815950920244,0.6319018404907976
189,seankellywalsh,1364,467,897,-389.6000000000006,0.34237536656891493,0.657624633431085
190,SimonLibdem,254,20,234,-209.79999999999998,0.07874015748031496,0.9212598425196851
191,tracey_crouch,252,76,176,-91.79999999999994,0.30158730158730157,0.6984126984126984
192,MarkHunter,651,229,422,-178.59999999999994,0.35176651305683565,0.6482334869431644
193,cheadlelabour,1461,433,1028,-545.0000000000016,0.29637234770704995,0.70362765229295
194,MaryRobinson01,475,216,259,-38.599999999999994,0.45473684210526316,0.5452631578947369
195,sj_robinson,831,220,611,-363.0000000000004,0.2647412755716005,0.7352587244283996
196,ChrisJVince,966,280,686,-381.8000000000006,0.2898550724637681,0.7101449275362319
197,_AlexSanderson,814,326,488,-136.79999999999984,0.4004914004914005,0.5995085995085995
198,AlexChalkChelt,710,272,438,-146.99999999999983,0.38309859154929576,0.6169014084507042
199,MartinChelt,848,295,553,-242.00000000000003,0.34787735849056606,0.652122641509434
200,bt_davies,1467,455,1012,-498.4000000000017,0.3101567825494206,0.6898432174505794
201,CherylGillan,9,3,6,-2.8,0.3333333333333333,0.6666666666666666
202,DrKirstenJ,755,246,509,-247.4000000000001,0.3258278145695364,0.6741721854304635
203,juliacambridge1,1430,476,954,-447.2000000000006,0.3328671328671329,0.6671328671328671
204,MarkVivis,143,44,99,-50.20000000000002,0.3076923076923077,0.6923076923076923
205,Andrew_RH_Smith,384,112,272,-148.39999999999992,0.2916666666666667,0.7083333333333334
206,ChichesterCA,112,44,68,-20.400000000000002,0.39285714285714285,0.6071428571428571
207,bilal_labour,1875,730,1145,-380.60000000000053,0.3893333333333333,0.6106666666666667
208,michelledonelan,505,189,316,-106.79999999999988,0.37425742574257426,0.6257425742574257
209,duncanhames,2297,679,1618,-874.7999999999998,0.2956029603831084,0.7043970396168916
210,AndyD_Newman,291,93,198,-100.80000000000001,0.31958762886597936,0.6804123711340206
211,AmyTrevethan,359,131,228,-82.99999999999996,0.3649025069637883,0.6350974930362117
212,stephenjohnfenn,5,0,5,-4.3999999999999995,0.0,1.0
213,LindsayHoyle_MP,811,321,490,-148.7999999999999,0.3958076448828607,0.6041923551171393
214,MarkFieldUK,467,181,286,-88.99999999999996,0.3875802997858672,0.6124197002141327
215,nikslingsby,145,50,95,-37.80000000000002,0.3448275862068966,0.6551724137931034
216,ChrisM4Chester,312,107,205,-88.39999999999998,0.34294871794871795,0.657051282051282
217,ChesterTories,3052,997,2055,-1016.0000000000013,0.3266710353866317,0.6733289646133683
218,cllrbobthompson,689,203,486,-262.79999999999995,0.2946298984034833,0.7053701015965167
219,cmartinLD,860,292,568,-261.20000000000016,0.3395348837209302,0.6604651162790698
220,DisgruntledRad,915,304,611,-287.9999999999999,0.33224043715846996,0.66775956284153
221,GilesWatling,536,187,349,-145.9999999999998,0.34888059701492535,0.6511194029850746
222,roy_horobin,84,22,62,-38.0,0.2619047619047619,0.7380952380952381
223,MrPeterKeith,786,277,509,-207.99999999999986,0.3524173027989822,0.6475826972010178
224,MartinVickers,232,84,148,-58.19999999999999,0.3620689655172414,0.6379310344827587
225,DavidClwydSouth,354,122,232,-98.59999999999995,0.3446327683615819,0.655367231638418
226,WxmBruce,689,198,491,-272.40000000000003,0.28737300435413643,0.7126269956458636
227,gareththomaslab,1176,421,755,-295.2000000000003,0.35799319727891155,0.6420068027210885
228,_mjsf_,1137,378,759,-345.60000000000076,0.3324538258575198,0.6675461741424802
229,CahalBurke,1315,454,861,-396.2000000000001,0.3452471482889734,0.6547528517110266
230,DPriceLabour,1783,545,1238,-635.8000000000011,0.3056646102075154,0.6943353897924845
231,harris4corby,7,2,5,-3.0,0.2857142857142857,0.7142857142857143
232,VotePursglove,1422,574,848,-229.7999999999997,0.40365682137834036,0.5963431786216596
233,LibDemRuss,128,36,92,-52.00000000000002,0.28125,0.71875
234,akhtar4coventry,5,0,5,-4.6,0.0,1.0
235,AndrewFurse,144,52,92,-37.20000000000002,0.3611111111111111,0.6388888888888888
236,gregjudge,1317,373,944,-527.0000000000014,0.2832194381169324,0.7167805618830676
237,CllrGaryRidley,474,169,305,-123.19999999999992,0.35654008438818563,0.6434599156118144
238,sjo400,558,182,376,-185.39999999999995,0.32616487455197135,0.6738351254480287
239,chrisoxlade,2439,892,1547,-586.0000000000008,0.36572365723657235,0.6342763427634276
240,fearnleymarr,677,212,465,-237.7999999999999,0.31314623338257014,0.6868537666174298
241,LabourSJ,1859,608,1251,-579.200000000002,0.3270575578267886,0.6729424421732114
242,MohanVidhi,656,247,409,-144.19999999999987,0.37652439024390244,0.6234756097560976
243,Emily_Benn,886,349,537,-154.79999999999998,0.3939051918735892,0.6060948081264108
244,CPhilpOfficial,534,187,347,-152.79999999999995,0.350187265917603,0.649812734082397
245,greggmcclymont,1148,362,786,-410.0000000000003,0.3153310104529617,0.6846689895470384
246,AnnClwyd,135,48,87,-37.60000000000001,0.35555555555555557,0.6444444444444445
247,JonCruddas_1,684,306,378,-69.99999999999997,0.4473684210526316,0.5526315789473685
248,JennyChapman,338,105,233,-107.1999999999999,0.3106508875739645,0.6893491124260355
249,curryannemarie,50,15,35,-20.599999999999998,0.3,0.7
250,pmcuthbertson,251,98,153,-51.60000000000001,0.3904382470119522,0.6095617529880478
251,Simon_Beard,309,89,220,-120.79999999999997,0.28802588996763756,0.7119741100323624
252,CampbellAbigail,852,315,537,-206.1999999999999,0.36971830985915494,0.6302816901408451
253,chhcalling,924,304,620,-298.8,0.329004329004329,0.670995670995671
254,MarkIsherwoodAM,20,7,13,-5.0,0.35,0.65
255,TomRippeth,3,0,3,-2.6,0.0,1.0
256,LanaHempsall,483,155,328,-160.19999999999993,0.32091097308488614,0.6790890269151139
257,mgjewellLD,966,283,683,-381.2000000000001,0.29296066252587993,0.7070393374741201
258,joenaitta,95,16,79,-60.599999999999994,0.16842105263157894,0.8315789473684211
259,EvonneWilliams,110,34,76,-34.800000000000004,0.3090909090909091,0.6909090909090909
260,Roobotham,1191,379,812,-403.40000000000066,0.31821998320738876,0.6817800167926112
261,bjlfearn,413,109,304,-174.99999999999986,0.2639225181598063,0.7360774818401937
262,Patrick4Dales,74,28,46,-17.000000000000004,0.3783783783783784,0.6216216216216216
263,ChrisWatts67,180,63,117,-52.40000000000002,0.35,0.65
264,simonreevell,381,137,244,-92.39999999999995,0.35958005249343833,0.6404199475065617
265,74Paterson,25,3,22,-18.0,0.12,0.88
266,Ed_Miliband,2439,906,1533,-564.8000000000014,0.3714637146371464,0.6285362853628537
267,CharlieElphicke,919,468,451,25.799999999999983,0.5092491838955386,0.49075081610446136
268,ClairHawkins,2905,1335,1570,-170.7999999999998,0.459552495697074,0.540447504302926
269,CouncillorLes,1035,304,731,-392.60000000000036,0.293719806763285,0.706280193236715
270,natashamillward,226,71,155,-75.99999999999999,0.3141592920353982,0.6858407079646017
271,mikejwood,764,241,523,-256.5999999999999,0.31544502617801046,0.6845549738219895
272,CllrJamesBarber,293,85,208,-115.79999999999994,0.2901023890784983,0.7098976109215017
273,fincarson,329,127,202,-66.8,0.3860182370820669,0.6139817629179332
274,DryburghArchie,937,338,599,-235.59999999999982,0.3607257203842049,0.6392742796157951
275,AmandaKubie,3,0,3,-3.0,0.0,1.0
276,DavidMundellDCT,878,357,521,-146.20000000000005,0.40660592255125283,0.5933940774487472
277,billabowman,71,20,51,-28.6,0.28169014084507044,0.7183098591549296
278,Craig4TheFerry,451,98,353,-249.20000000000002,0.21729490022172948,0.7827050997782705
279,ColemanDundee,450,101,349,-242.20000000000002,0.22444444444444445,0.7755555555555556
280,michaeljmarra,697,215,482,-245.79999999999993,0.3084648493543759,0.6915351506456241
281,James_Reekie1,2008,652,1356,-638.4000000000012,0.3247011952191235,0.6752988047808764
282,marygwengriff,2153,751,1402,-602.4000000000015,0.34881560613098,0.6511843938690199
283,VirendraSharma,735,236,499,-214.59999999999977,0.32108843537414966,0.6789115646258503
284,JSymesUK,527,172,355,-164.99999999999994,0.32637571157495254,0.6736242884250474
285,LibDemEastDevon,502,132,370,-222.3999999999999,0.26294820717131473,0.7370517928286853
286,HugoSwire,1009,508,501,21.79999999999999,0.5034687809712587,0.4965312190287413
287,samirjassal,166,51,115,-57.600000000000016,0.3072289156626506,0.6927710843373494
288,DamianHinds,724,276,448,-158.39999999999995,0.3812154696132597,0.6187845303867403
289,RRobinsonLD,160,53,107,-52.999999999999986,0.33125,0.66875
290,alexwilks88,303,100,203,-93.19999999999996,0.33003300330033003,0.66996699669967
291,PaulMcGarryUK,1629,447,1182,-696.5999999999991,0.27440147329650094,0.7255985267034991
292,GrahamSMSP,1435,433,1002,-508.4000000000014,0.3017421602787456,0.6982578397212543
293,Fiona4Labour,1953,717,1236,-463.00000000000125,0.3671274961597542,0.6328725038402457
294,ettiespencer,34,8,26,-17.4,0.23529411764705882,0.7647058823529411
295,gcowie4eastren,64,27,37,-8.0,0.421875,0.578125
296,SamGyimah,1462,506,956,-403.8000000000005,0.34610123119015046,0.6538987688098495
297,whyteleafedavid,1006,269,737,-428.8000000000006,0.2673956262425447,0.7326043737574552
298,RobertLibDem,574,88,486,-270.3999999999989,0.15331010452961671,0.8466898954703833
299,Kevin_Hickson,115,45,70,-23.200000000000003,0.391304347826087,0.6086956521739131
300,GregKnight,687,237,450,-190.5999999999998,0.34497816593886466,0.6550218340611353
301,Caroline_Ansell,1179,480,699,-191.19999999999985,0.4071246819338422,0.5928753180661578
302,JakeyLambert,1551,487,1064,-530.8000000000014,0.31399097356544164,0.6860090264345583
303,StephenLloydEBN,324,130,194,-54.99999999999999,0.4012345679012346,0.5987654320987654
304,eddisburylabour,771,206,565,-338.60000000000014,0.26718547341115434,0.7328145265888456
305,KarenJUtting,12,3,9,-6.2,0.25,0.75
306,IanMurrayMP,1139,440,699,-242.4000000000001,0.3863037752414399,0.6136962247585601
307,lib_dem_dan,161,59,102,-43.0,0.36645962732919257,0.6335403726708074
308,henderson_ricky,537,189,348,-139.39999999999986,0.35195530726256985,0.6480446927374302
309,MikeCrockart,2147,561,1586,-945.8000000000018,0.2612948299953423,0.7387051700046576
310,cllrcammyday,1675,497,1178,-610.400000000001,0.2967164179104478,0.7032835820895522
311,LSPaterson,159,50,109,-53.00000000000001,0.31446540880503143,0.6855345911949685
312,GonulDaniels,1155,326,829,-487.0000000000005,0.28225108225108225,0.7177489177489178
313,Fletch_1976,305,115,190,-66.79999999999998,0.3770491803278688,0.6229508196721312
314,GoltonStewart,463,166,297,-121.79999999999991,0.35853131749460043,0.6414686825053996
315,vron_king,2387,890,1497,-540.6000000000017,0.3728529534981148,0.6271470465018852
316,AlecShelbrooke,839,296,543,-230.9999999999999,0.3528009535160906,0.6471990464839095
317,Spencer_Drury,881,292,589,-274.99999999999994,0.3314415437003405,0.6685584562996595
318,CliveEfford,200,78,122,-39.39999999999999,0.39,0.61
319,euandavidson,1,1,0,1.0,1.0,0.0
320,geraldhowarth,365,140,225,-76.19999999999993,0.3835616438356164,0.6164383561643836
321,helenharrisonuk,332,129,203,-65.79999999999995,0.3885542168674699,0.6114457831325302
322,CllrPaulHarvey,1005,352,653,-277.40000000000003,0.3502487562189055,0.6497512437810945
323,JohnMannMP,131,37,94,-53.6,0.2824427480916031,0.7175572519083969
324,Ollie_Middleton,1,1,0,1.0,1.0,0.0
325,JaneEllison,199,110,89,17.8,0.5527638190954773,0.4472361809045226
326,WillJMartindale,1,1,0,1.0,1.0,0.0
327,John2Win,1352,491,861,-340.4000000000004,0.3631656804733728,0.6368343195266272
328,rushanaraali,585,219,366,-134.59999999999988,0.37435897435897436,0.6256410256410256
329,DrDickyD,1,1,0,1.0,1.0,0.0
330,RogerGodsiff,451,139,312,-166.60000000000005,0.3082039911308204,0.6917960088691796
331,khalid4PB,25,6,19,-11.600000000000001,0.24,0.76
332,johnhemming4mp,904,225,679,-443.20000000000033,0.2488938053097345,0.7511061946902655
333,Kate_HollernMP,1,0,1,-1.0,0.0,1.0
334,peterfor2017,1,0,1,-1.0,0.0,1.0
335,traceymwest,1,0,1,-1.0,0.0,1.0
336,atbutcher,1245,204,1041,-657.0000000000049,0.163855421686747,0.8361445783132531
337,_ChrisKealey,48,16,32,-14.999999999999998,0.3333333333333333,0.6666666666666666
338,Tobias_Ellwood,691,335,356,-24.19999999999998,0.48480463096960924,0.5151953690303908
339,MaryMacleodUK,1698,736,962,-181.19999999999973,0.4334511189634865,0.5665488810365136
340,lbpreston,199,67,132,-60.19999999999999,0.33668341708542715,0.6633165829145728
341,theodoraclarke,1163,512,651,-110.99999999999974,0.4402407566638005,0.5597592433361995
342,CharlotteLeslie,225,81,144,-55.79999999999996,0.36,0.64
343,JulieForBurnley,200,62,138,-69.80000000000001,0.31,0.69
344,IvanLewis_MP,200,73,127,-49.39999999999998,0.365,0.635
345,johnerskine,1,1,0,1.0,1.0,0.0
346,HarrietHarman,675,197,478,-255.39999999999975,0.29185185185185186,0.7081481481481482
347,delyth_evans,1,0,1,-1.0,0.0,1.0
348,Simonhartmp,1,0,1,-1.0,0.0,1.0
349,jackabbott90,1,1,0,1.0,1.0,0.0
350,tracey_crouch,252,76,176,-91.79999999999994,0.30158730158730157,0.6984126984126984
351,MaryRobinson01,475,216,259,-38.599999999999994,0.45473684210526316,0.5452631578947369
352,_AlexSanderson,1,1,0,1.0,1.0,0.0
353,juliacambridge1,1,0,1,-0.8,0.0,1.0
354,bilal_labour,198,81,117,-33.59999999999999,0.4090909090909091,0.5909090909090909
355,_mjsf_,1,0,1,-1.0,0.0,1.0
356,gregjudge,1,1,0,1.0,1.0,0.0
357,sjo400,1,0,1,-1.0,0.0,1.0
358,Emily_Benn,1,1,0,1.0,1.0,0.0
359,Patrick4Dales,1,1,0,1.0,1.0,0.0
360,Ed_Miliband,2439,906,1533,-564.8000000000014,0.3714637146371464,0.6285362853628537
361,CharlieElphicke,919,468,451,25.799999999999983,0.5092491838955386,0.49075081610446136
362,CouncillorLes,1,0,1,-1.0,0.0,1.0
363,James_Reekie1,1,1,0,1.0,1.0,0.0
364,SamGyimah,1,0,1,-1.0,0.0,1.0
365,IanMurrayMP,1139,440,699,-242.4000000000001,0.3863037752414399,0.6136962247585601
366,henderson_ricky,1,0,1,-1.0,0.0,1.0
367,MikeCrockart,2179,573,1606,-954.6000000000017,0.262964662689307,0.7370353373106929
368,AlecShelbrooke,839,296,543,-230.9999999999999,0.3528009535160906,0.6471990464839095
369,CliveEfford,1637,531,1106,-527.0000000000013,0.3243738546120953,0.6756261453879047
370,carajenkinson,1161,364,797,-395.00000000000085,0.31352282515073215,0.6864771748492678
371,joanryanEnfield,953,404,549,-122.59999999999985,0.42392444910807975,0.5760755508919203
372,DavidBurrowesUK,1231,349,882,-502.00000000000074,0.2835093419983753,0.7164906580016247
373,BambosMP,668,274,394,-107.00000000000006,0.4101796407185629,0.5898203592814372
374,papadeltasierra,599,182,417,-223.4000000000001,0.3038397328881469,0.6961602671118531
375,GarethPBarrett,328,115,213,-90.59999999999995,0.35060975609756095,0.649390243902439
376,eleanor4epping,72,27,45,-13.999999999999998,0.375,0.625
377,jon_whitehouse,1432,500,932,-405.8000000000007,0.34916201117318435,0.6508379888268156
378,EpsomEwellFocus,1923,627,1296,-621.4000000000013,0.32605304212168484,0.6739469578783152
379,catkinson80,1037,343,694,-331.8000000000003,0.33076181292189005,0.6692381870781099
380,waddertron,196,81,115,-33.199999999999996,0.413265306122449,0.5867346938775511
381,CllrAndrewDavis,231,56,175,-109.59999999999997,0.24242424242424243,0.7575757575757576
382,JoelforExeter,97,27,70,-40.400000000000006,0.27835051546391754,0.7216494845360825
383,Karen4Falkirk,236,88,148,-57.400000000000006,0.3728813559322034,0.6271186440677966
384,SuellaFernandes,454,201,253,-43.599999999999994,0.44273127753303965,0.5572687224669604
385,mwinnington,688,215,473,-238.40000000000012,0.3125,0.6875
386,dezairedale,74,31,43,-10.799999999999997,0.4189189189189189,0.581081081081081
387,Helen_Whately,79,26,53,-24.199999999999996,0.3291139240506329,0.6708860759493671
388,SimonNayyar,528,199,329,-110.99999999999982,0.3768939393939394,0.6231060606060606
389,petebruce4,36,11,25,-13.2,0.3055555555555556,0.6944444444444444
390,JackLopresti,297,121,176,-53.40000000000001,0.4074074074074074,0.5925925925925926
391,sarahsackman,1055,445,610,-140.7999999999998,0.4218009478672986,0.5781990521327014
392,LynneBeaumont,2552,828,1724,-824.6000000000005,0.32445141065830724,0.6755485893416928
393,Mark_J_Harper,671,262,409,-131.99999999999983,0.39046199701937406,0.6095380029806259
394,steveparryhearn,661,229,432,-185.8000000000001,0.3464447806354009,0.653555219364599
395,fivanmierlo,119,35,84,-45.2,0.29411764705882354,0.7058823529411765
396,sullivan_jed,1084,263,821,-529.8000000000008,0.24261992619926198,0.757380073800738
397,EdwardLeighMP,123,50,73,-21.400000000000002,0.4065040650406504,0.5934959349593496
398,AnnaMartinLD,196,64,132,-62.99999999999998,0.32653061224489793,0.673469387755102
399,frankhindle,16,9,7,3.000000000000001,0.5625,0.4375
400,Tom_Smith26,1475,459,1016,-520.8000000000008,0.3111864406779661,0.6888135593220339
401,Abbott4Gedling,187,67,120,-51.600000000000016,0.3582887700534759,0.6417112299465241
402,Vernon_Coaker,1623,624,999,-339.40000000000055,0.3844731977818854,0.6155268022181146
403,medwaypaul,148,27,121,-87.79999999999995,0.18243243243243243,0.8175675675675675
404,Rehman_Chishti,588,306,282,28.999999999999996,0.5204081632653061,0.47959183673469385
405,PaulClark4GandR,1570,532,1038,-475.40000000000094,0.33885350318471336,0.6611464968152866
406,simonbone,238,41,197,-130.39999999999992,0.1722689075630252,0.8277310924369747
407,cmykey,1102,253,849,-537.8000000000011,0.2295825771324864,0.7704174228675136
408,Margaret_Curran,1270,449,821,-343.60000000000065,0.3535433070866142,0.6464566929133858
409,JadeEONeil,442,159,283,-116.39999999999998,0.3597285067873303,0.6402714932126696
410,ewanhoyle,1586,530,1056,-482.200000000001,0.33417402269861285,0.6658259773013872
411,GordonMccaskill,679,162,517,-325.6000000000002,0.23858615611192932,0.7614138438880707
412,sophygardner,2457,847,1610,-686.4000000000015,0.34472934472934474,0.6552706552706553
413,jeremy4glos,740,208,532,-302.00000000000017,0.2810810810810811,0.7189189189189189
414,Colin_J_Clark,40,13,27,-12.6,0.325,0.675
415,cajardineMP,646,171,475,-281.2000000000001,0.2647058823529412,0.7352941176470589
416,cj_dinenage,233,86,147,-53.2,0.36909871244635195,0.630901287553648
417,alanejdurrant,133,26,107,-70.80000000000003,0.19548872180451127,0.8045112781954887
418,Byron_Davies,1912,621,1291,-576.800000000002,0.3247907949790795,0.6752092050209205
419,HarrishBigb5,21,4,17,-12.6,0.19047619047619047,0.8095238095238095
420,NickBoles,621,272,349,-66.99999999999996,0.43800322061191627,0.5619967793880838
421,barriefairbairn,113,33,80,-45.400000000000006,0.2920353982300885,0.7079646017699115
422,TanDhesi,833,302,531,-207.6,0.3625450180072029,0.6374549819927972
423,lara_norris,1695,615,1080,-407.6000000000009,0.36283185840707965,0.6371681415929203
424,MattHartley100,508,153,355,-186.40000000000006,0.30118110236220474,0.6988188976377953
425,AnneMilton,2280,816,1464,-611.6000000000014,0.35789473684210527,0.6421052631578947
426,simondedeney,1141,310,831,-479.2000000000013,0.27169149868536374,0.7283085013146363
427,hackneyamyg,2073,713,1360,-590.8000000000013,0.3439459720212253,0.6560540279787748
428,Jack_Tinley,194,72,122,-44.400000000000034,0.3711340206185567,0.6288659793814433
429,JamesMorris,1052,358,694,-314.4000000000002,0.3403041825095057,0.6596958174904943
430,Steph_Peacock,1885,604,1281,-608.8000000000018,0.3204244031830239,0.6795755968169761
431,Allott4action,461,158,303,-139.4,0.34273318872017355,0.6572668112798264
432,HollyLynch5,204,65,139,-66.6,0.31862745098039214,0.6813725490196079
433,XanderEdz77,167,57,110,-47.00000000000001,0.3413173652694611,0.6586826347305389
434,rsbate,263,102,161,-50.6,0.38783269961977185,0.6121673003802282
435,mdlloyd,32,15,17,-1.1999999999999997,0.46875,0.53125
436,DerekTwiggMP,203,74,129,-52.8,0.3645320197044335,0.6354679802955665
437,SimonMarcus,690,256,434,-170.80000000000004,0.3710144927536232,0.6289855072463768
438,Zuffar_Haq,94,29,65,-33.400000000000006,0.30851063829787234,0.6914893617021277
439,Sundip,1257,492,765,-237.99999999999994,0.3914081145584726,0.6085918854415274
440,flynnhc,1534,569,965,-366.0000000000005,0.3709256844850065,0.6290743155149935
441,AJonesMP,664,243,421,-164.99999999999991,0.36596385542168675,0.6340361445783133
442,LabourHarrogate,275,79,196,-108.39999999999992,0.2872727272727273,0.7127272727272728
443,ross_barlow,452,137,315,-172.2,0.3030973451327434,0.6969026548672567
444,Uma_Kumaran,1400,535,865,-289.6000000000002,0.3821428571428571,0.6178571428571429
445,HannahDavid_HW,818,292,526,-213.4,0.3569682151589242,0.6430317848410758
446,Iain_Wright_,1264,532,732,-174.9999999999999,0.4208860759493671,0.5791139240506329
447,ECarlssonBrowne,114,43,71,-25.0,0.37719298245614036,0.6228070175438597
448,bernardjenkin,1023,384,639,-243.39999999999984,0.375366568914956,0.624633431085044
449,nickperrylibdem,1108,365,743,-350.20000000000044,0.32942238267148016,0.6705776173285198
450,AmberRuddHR,1855,783,1072,-255.8000000000003,0.42210242587601077,0.5778975741239892
451,AlanMakMP,339,161,178,-8.399999999999993,0.4749262536873156,0.5250737463126843
452,stevesollitt,675,233,442,-199.59999999999988,0.3451851851851852,0.6548148148148148
453,Lisa_Smart,869,349,520,-136.59999999999965,0.4016110471806674,0.5983889528193326
454,William_Wragg,753,324,429,-96.39999999999995,0.4302788844621514,0.5697211155378487
455,UKpolicywatch,332,149,183,-23.600000000000016,0.44879518072289154,0.5512048192771084
456,CllrRFM,130,33,97,-49.20000000000003,0.25384615384615383,0.7461538461538462
457,Pearson4Halifax,1253,412,841,-389.2000000000011,0.32881085395051873,0.6711891460494812
458,jon_trickett,702,199,503,-284.6000000000002,0.28347578347578345,0.7165242165242165
459,Andrew_Dismore,798,239,559,-286.8000000000001,0.29949874686716793,0.7005012531328321
460,hill4hendon,1845,579,1266,-657.6000000000007,0.31382113821138213,0.6861788617886179
461,Offord4Hendon,300,96,204,-101.19999999999996,0.32,0.68
462,Sue4Henley,57,16,41,-22.200000000000003,0.2807017543859649,0.7192982456140351
463,JHowellUK,1284,477,807,-315.8000000000003,0.37149532710280375,0.6285046728971962
464,HerefordLabour,45,13,32,-15.999999999999998,0.28888888888888886,0.7111111111111111
465,LucyHurds,504,164,340,-156.79999999999995,0.3253968253968254,0.6746031746031746
466,Jesse_Norman,228,60,168,-100.6,0.2631578947368421,0.7368421052631579
467,ChibahKatherine,619,235,384,-127.99999999999989,0.37964458804523427,0.6203554119547657
468,michaelgreen01,1107,347,760,-383.00000000000017,0.3134598012646793,0.6865401987353207
469,PriskMark,1025,312,713,-375.60000000000036,0.304390243902439,0.6956097560975609
470,CllrRButler,923,277,646,-340.4000000000003,0.3001083423618635,0.6998916576381365
471,LiamRCarr,2690,948,1742,-732.2000000000011,0.3524163568773234,0.6475836431226766
472,iaingartside,632,189,443,-238.7999999999999,0.2990506329113924,0.7009493670886076
473,ajsmith_libdem,663,211,452,-221.9999999999998,0.31825037707390647,0.6817496229260935
474,LadyPHackney,217,70,147,-66.60000000000001,0.3225806451612903,0.6774193548387096
475,will_blair,1783,766,1017,-220.1999999999997,0.4296130117779024,0.5703869882220975
476,jillfraser6,136,47,89,-38.800000000000004,0.34558823529411764,0.6544117647058824
477,Keir_Starmer,363,167,196,-17.600000000000005,0.46005509641873277,0.5399449035812672
478,mcgearyp_paul,47,14,33,-16.200000000000003,0.2978723404255319,0.7021276595744681
479,horshamlabour,238,79,159,-77.79999999999995,0.3319327731092437,0.6680672268907563
480,3147Hay,2,0,2,-2.0,0.0,1.0
481,bphillipsonMP,1322,487,835,-326.00000000000034,0.36838124054462934,0.6316187594553706
482,itratali1,578,231,347,-108.80000000000001,0.39965397923875434,0.6003460207612457
483,JDjanogly,1148,419,729,-282.4,0.36498257839721254,0.6350174216027874
484,CambridgeMagpie,631,235,396,-152.3999999999999,0.3724247226624406,0.6275752773375595
485,KevinHorkin,1521,564,957,-363.20000000000067,0.3708086785009862,0.6291913214990138
486,RichBJC,45,7,38,-29.6,0.15555555555555556,0.8444444444444444
487,ChrisChapman86,1004,338,666,-297.80000000000024,0.33665338645418325,0.6633466135458167
488,JGJabbour,11,5,6,-0.8000000000000002,0.45454545454545453,0.5454545454545454
489,InverclydeLD,64,16,48,-30.0,0.25,0.75
490,dannyalexander,1870,722,1148,-376.60000000000076,0.386096256684492,0.613903743315508
491,1edmountain,236,46,190,-105.40000000000003,0.19491525423728814,0.8050847457627118
492,mgrobb,1304,395,909,-491.8000000000007,0.3029141104294479,0.6970858895705522
493,LibDems_Ipswich,126,37,89,-49.599999999999994,0.29365079365079366,0.7063492063492064
494,davidellesmere,281,105,176,-60.40000000000001,0.3736654804270463,0.6263345195729537
495,gummerben,113,26,87,-58.2,0.23008849557522124,0.7699115044247787
496,DIGoodall,342,97,245,-137.59999999999988,0.28362573099415206,0.716374269005848
497,alexburghart,420,158,262,-87.39999999999995,0.3761904761904762,0.6238095238095238
498,northislington,469,149,320,-156.39999999999984,0.31769722814498935,0.6823027718550106
499,DrMarkLim,280,79,201,-110.19999999999997,0.28214285714285714,0.7178571428571429
500,SWEValleys,274,45,229,-165.59999999999985,0.16423357664233576,0.8357664233576643
501,jarrowstevemp,80,25,55,-28.200000000000006,0.3125,0.6875
502,njwMason,54,13,41,-26.2,0.24074074074074073,0.7592592592592593
503,KeighleyLabour,585,188,397,-196.4000000000001,0.3213675213675214,0.6786324786324787
504,richdick,1566,597,969,-341.20000000000033,0.38122605363984674,0.6187739463601533
505,BallySingh74,1194,297,897,-553.4000000000013,0.24874371859296482,0.7512562814070352
506,backborwick,91,38,53,-13.8,0.4175824175824176,0.5824175824175825
507,RheaKeehn,724,260,464,-172.7999999999997,0.35911602209944754,0.6408839779005525
508,BrianWhittle,1371,462,909,-406.0000000000008,0.33698030634573306,0.6630196936542669
509,EdwardJDavey,684,217,467,-229.39999999999998,0.3172514619883041,0.6827485380116959
510,Godfrey_Lee,788,234,554,-298.60000000000014,0.2969543147208122,0.7030456852791879
511,christinemackay,747,260,487,-216.4,0.34805890227576974,0.6519410977242303
512,cllrmikeross,315,100,215,-105.59999999999992,0.31746031746031744,0.6825396825396826
513,JB4Hull,103,34,69,-29.400000000000006,0.3300970873786408,0.6699029126213593
514,clairethomas1,910,346,564,-195.40000000000006,0.3802197802197802,0.6197802197802198
515,sgloslibdems,127,51,76,-27.2,0.4015748031496063,0.5984251968503937
516,CSkidmoreUK,1040,337,703,-333.8000000000005,0.32403846153846155,0.6759615384615385
517,cllrdavedempsey,1014,286,728,-407.80000000000075,0.28205128205128205,0.717948717948718
518,Alice4Knowsley,57,24,33,-7.199999999999999,0.42105263157894735,0.5789473684210527
519,CarlCashman,361,123,238,-103.39999999999996,0.3407202216066482,0.6592797783933518
520,Osborne4Lagan,81,24,57,-29.200000000000003,0.2962962962962963,0.7037037037037037
521,JimHood_Labour,480,166,314,-135.19999999999993,0.3458333333333333,0.6541666666666667
522,CatSmithMP,1521,535,986,-416.4000000000007,0.3517422748191979,0.6482577251808022
523,hilarybennmp,1473,590,883,-248.99999999999974,0.40054310930074677,0.5994568906992532
524,NicolaFWilson,202,59,143,-75.6,0.29207920792079206,0.7079207920792079
525,edsanderson,554,156,398,-220.5999999999998,0.2815884476534296,0.7184115523465704
526,Stephenson_Ryan,122,51,71,-18.199999999999996,0.4180327868852459,0.5819672131147541
527,AqilaChoudhry,959,314,645,-297.60000000000025,0.32742440041710114,0.6725755995828988
528,aptsw1,715,255,460,-188.3999999999999,0.35664335664335667,0.6433566433566433
529,Kishan_Devani,688,262,426,-146.19999999999982,0.3808139534883721,0.6191860465116279
530,DaveRaval,935,295,640,-319.80000000000035,0.3155080213903743,0.6844919786096256
531,Leon_Leicester,31,11,20,-8.0,0.3548387096774194,0.6451612903225806
532,PaulForWest,2,0,2,-1.8,0.0,1.0
533,LDTownson,2818,935,1883,-868.5999999999996,0.3317955997161107,0.6682044002838893
534,lloyd_rm,1266,445,821,-353.9999999999999,0.35150078988941547,0.6484992101105845
535,PeterTFortune,1127,443,684,-208.79999999999973,0.3930789707187223,0.6069210292812778
536,alexfeakes,789,230,559,-303.80000000000024,0.2915082382762991,0.7084917617237009
537,russellantony,130,50,80,-27.799999999999994,0.38461538461538464,0.6153846153846154
538,BimAfolami,191,79,112,-26.6,0.41361256544502617,0.5863874345549738
539,vickyfoxcroft,1553,527,1026,-459.20000000000095,0.339343206696716,0.660656793303284
540,JohnCryerMP,46,9,37,-25.6,0.1956521739130435,0.8043478260869565
541,ChrisWorsey,1778,605,1173,-518.2000000000014,0.34026996625421824,0.6597300337457818
542,RossDPepper,1547,455,1092,-565.600000000001,0.29411764705882354,0.7058823529411765
543,emasykes,17,8,9,-1.0,0.47058823529411764,0.5294117647058824
544,LiverLibDems,1200,253,947,-639.000000000002,0.21083333333333334,0.7891666666666667
545,jacksonngUK,1695,445,1250,-738.0000000000033,0.26253687315634217,0.7374631268436578
546,norsheenbhatti,2,1,1,-0.19999999999999996,0.5,0.5
547,patmoloney,3,0,3,-2.6,0.0,1.0
548,Steve4LCRmayor,346,94,252,-142.59999999999994,0.27167630057803466,0.7283236994219653
549,LeoEvans94,346,101,245,-134.39999999999992,0.29190751445086704,0.708092485549133
550,EdmcRandal,655,218,437,-202.59999999999977,0.332824427480916,0.667175572519084
551,NiaGriffithMP,560,198,362,-152.79999999999998,0.3535714285714286,0.6464285714285715
552,SelaineSaxby,583,204,379,-150.39999999999975,0.34991423670668953,0.6500857632933105
553,NickyMorgan01,498,229,269,-31.000000000000032,0.4598393574297189,0.5401606425702812
554,LoughbroMatthew,1405,444,961,-476.40000000000043,0.31601423487544483,0.6839857651245551
555,CllrMattBrown,260,79,181,-91.39999999999998,0.3038461538461538,0.6961538461538461
556,LibDemCharlotte,159,49,110,-55.6,0.3081761006289308,0.6918238993710691
557,Dunne4Ludlow,348,128,220,-82.99999999999999,0.367816091954023,0.632183908045977
558,dean_r,2278,723,1555,-748.2000000000006,0.3173836698858648,0.6826163301141353
559,Neil_Christian,1140,355,785,-396.00000000000034,0.31140350877192985,0.6885964912280702
560,timroca85,695,233,462,-217.39999999999998,0.33525179856115106,0.6647482014388489
561,DavidRutley,1153,525,628,-92.99999999999993,0.45533391153512576,0.5446660884648742
562,charlie_rsmith,824,317,507,-163.19999999999982,0.38470873786407767,0.6152912621359223
563,JasperGerardLD,733,248,485,-221.79999999999995,0.3383356070941337,0.6616643929058663
564,HelenGrantMP,1713,848,865,24.400000000000052,0.4950379451255108,0.5049620548744892
565,allen_m_simpson,500,166,334,-159.99999999999997,0.332,0.668
566,Y_FovargueMP,945,253,692,-405.4000000000003,0.2677248677248677,0.7322751322751323
567,EdwardsEconomy,125,32,93,-54.60000000000001,0.256,0.744
568,JWhittingdale,4,1,3,-2.2,0.25,0.75
569,XXingang,254,82,172,-81.60000000000001,0.3228346456692913,0.6771653543307087
570,RobGManning,2134,796,1338,-497.0000000000019,0.37300843486410495,0.626991565135895
571,JeffSmithetc,567,188,379,-175.1999999999999,0.3315696649029982,0.6684303350970018
572,Chris_Carrigan1,39,15,24,-9.4,0.38461538461538464,0.6153846153846154
573,dr_mckenna,406,162,244,-69.60000000000001,0.39901477832512317,0.6009852216748769
574,a_adeyemo,1424,498,926,-402.60000000000025,0.3497191011235955,0.6502808988764045
575,mcneil_tom,1522,429,1093,-611.2000000000011,0.2818659658344284,0.7181340341655716
576,spelmanc,362,153,209,-54.6,0.42265193370165743,0.5773480662983426
577,LindaAnneJack,1738,587,1151,-531.2000000000012,0.3377445339470656,0.6622554660529344
578,CharlynnePullen,622,201,421,-210.79999999999998,0.32315112540192925,0.6768488745980707
579,nicolaheaton,642,224,418,-181.79999999999993,0.34890965732087226,0.6510903426791277
580,Pauline_Latham,1409,547,862,-283.39999999999975,0.38821859474804826,0.6117814052519518
581,Patsindorset,1328,412,916,-466.20000000000124,0.3102409638554217,0.6897590361445783
582,Michael4MDNP,1010,359,651,-266.59999999999997,0.35544554455445543,0.6445544554455446
583,Speedy1968,219,70,149,-70.0,0.319634703196347,0.680365296803653
584,libdemdaisy,1333,344,989,-596.600000000001,0.25806451612903225,0.7419354838709677
585,HuddlestonNigel,217,76,141,-59.99999999999999,0.35023041474654376,0.6497695852534562
586,rlunn47,11,3,8,-3.6000000000000005,0.2727272727272727,0.7272727272727273
587,rowlem,32,7,25,-15.599999999999998,0.21875,0.78125
588,RKilpatrickMCR,539,179,360,-183.00000000000006,0.3320964749536178,0.6679035250463822
589,AndyMcDonaldMP,812,348,464,-97.40000000000002,0.42857142857142855,0.5714285714285714
590,WillGoodhand4MP,587,248,339,-75.19999999999995,0.42248722316865417,0.5775127768313458
591,BallantyneMl,41,8,33,-22.999999999999996,0.1951219512195122,0.8048780487804879
592,emily4MK,2803,869,1934,-997.8000000000004,0.31002497324295397,0.689975026757046
593,MarkLancasterMK,1304,502,802,-258.19999999999976,0.38496932515337423,0.6150306748466258
594,iainastewart,1020,381,639,-230.19999999999973,0.3735294117647059,0.6264705882352941
595,pauljholmes,2304,666,1638,-917.8000000000017,0.2890625,0.7109375
596,DavidTCDavies,1331,460,871,-403.5999999999999,0.3456048084147258,0.6543951915852743
597,veronicakgerman,114,52,62,-7.199999999999999,0.45614035087719296,0.543859649122807
598,ruthjoneswales,675,261,414,-140.79999999999995,0.38666666666666666,0.6133333333333333
599,GlynDavies,775,243,532,-265.2,0.3135483870967742,0.6864516129032258
600,DoddsJane,220,94,126,-30.4,0.42727272727272725,0.5727272727272728
601,MartynSingleton,972,220,752,-502.00000000000097,0.22633744855967078,0.7736625514403292
602,Douglas4Moray,134,50,84,-34.4,0.373134328358209,0.6268656716417911
603,davidmorrisml,1992,641,1351,-700.5999999999995,0.3217871485943775,0.6782128514056225
604,Matt_Severn,159,55,104,-45.60000000000001,0.34591194968553457,0.6540880503144654
605,andreajenkyns,1032,378,654,-255.59999999999988,0.36627906976744184,0.6337209302325582
606,RuaraidhF,442,112,330,-198.19999999999987,0.25339366515837103,0.746606334841629
607,ClareBentley13,46,7,39,-31.4,0.15217391304347827,0.8478260869565217
608,BruceTennent,19,5,14,-8.6,0.2631578947368421,0.7368421052631579
609,LabourNFW,31,5,26,-19.4,0.16129032258064516,0.8387096774193549
610,imogen4nfwest,486,159,327,-158.99999999999997,0.3271604938271605,0.6728395061728395
611,DesmondSwayne,168,59,109,-42.200000000000024,0.35119047619047616,0.6488095238095238
612,SiberianT,353,70,283,-196.59999999999988,0.19830028328611898,0.8016997167138811
613,RobertJenrick,1218,523,695,-152.99999999999986,0.4293924466338259,0.5706075533661741
614,MichaelPayneUK,1674,632,1042,-369.4000000000008,0.37753882915173237,0.6224611708482676
615,RichardBenyonMP,1089,408,681,-254.80000000000004,0.3746556473829201,0.6253443526170799
616,cott_nick,398,117,281,-155.39999999999992,0.29396984924623115,0.7060301507537688
617,skitchen82,146,44,102,-55.00000000000001,0.3013698630136986,0.6986301369863014
618,NewcastleEastLD,113,42,71,-26.6,0.37168141592920356,0.6283185840707964
619,CatMcKinnell,420,157,263,-92.39999999999993,0.3738095238095238,0.6261904761904762
620,nullibdems,967,174,793,-605.0000000000001,0.17993795243019647,0.8200620475698035
621,jessicamordenmp,961,377,584,-177.5999999999997,0.3922996878251821,0.6077003121748179
622,PaulFlynnMP,29,8,21,-12.8,0.27586206896551724,0.7241379310344828
623,EdTby1,9,3,6,-3.0,0.3333333333333333,0.6666666666666666
624,RoyFreer,1923,370,1553,-1048.0000000000039,0.19240769630785232,0.8075923036921477
625,AnneMarieMorris,1784,742,1042,-274.19999999999993,0.41591928251121074,0.5840807174887892
626,YvetteCooperMP,787,274,513,-220.59999999999994,0.34815756035578144,0.6518424396442185
627,CalFreeman,741,284,457,-156.19999999999993,0.3832658569500675,0.6167341430499326
628,scottmann4NC,431,138,293,-142.79999999999993,0.32018561484918795,0.679814385150812
629,NCORNWALLCLP,861,190,671,-411.8000000000011,0.22067363530778164,0.7793263646922184
630,markcann,56,29,27,2.4000000000000004,0.5178571428571429,0.48214285714285715
631,NickHarveyND,139,46,93,-43.200000000000024,0.33093525179856115,0.6690647482014388
632,PeterNorthDevon,1510,622,888,-235.99999999999997,0.4119205298013245,0.5880794701986755
633,Simon4NDorset,87,45,42,3.0000000000000004,0.5172413793103449,0.4827586206896552
634,MarkBrotherston,322,113,209,-85.59999999999997,0.35093167701863354,0.6490683229813664
635,TishGlossop,31,17,14,3.2,0.5483870967741935,0.45161290322580644
636,KevanJonesMP,1576,462,1114,-616.0000000000007,0.29314720812182743,0.7068527918781726
637,LNethsingha,67,23,44,-17.599999999999998,0.34328358208955223,0.6567164179104478
638,KRustidge,1360,402,958,-516.6000000000007,0.29558823529411765,0.7044117647058824
639,Lee4NED,730,231,499,-243.99999999999994,0.31643835616438354,0.6835616438356165
640,HuwBell1,2334,867,1467,-552.4000000000021,0.37146529562982006,0.62853470437018
641,CllrTimBrett,527,153,374,-214.39999999999995,0.2903225806451613,0.7096774193548387
642,Brian_R_Thomson,458,138,320,-151.79999999999973,0.30131004366812225,0.6986899563318777
643,AmranHussain,2013,768,1245,-422.0000000000015,0.38152011922503726,0.6184798807749627
644,geekofhearts,1109,509,600,-73.19999999999999,0.45897204688908927,0.5410279531109107
645,ChrisYorkUK,1276,320,956,-588.4000000000012,0.2507836990595611,0.7492163009404389
646,ToddDForeman,1139,444,695,-218.40000000000003,0.38981562774363476,0.6101843722563652
647,Wera_Hobhouse,691,216,475,-240.79999999999998,0.3125904486251809,0.6874095513748191
648,jeanie4northhfd,188,80,108,-29.200000000000003,0.425531914893617,0.574468085106383
649,SallyPrentice,633,258,375,-131.60000000000002,0.4075829383886256,0.5924170616113744
650,thedeniseb,2376,854,1522,-606.6000000000014,0.35942760942760943,0.6405723905723906
651,graeme_currie1,205,68,137,-66.80000000000001,0.33170731707317075,0.6682926829268293
652,OwenPaterson,270,115,155,-37.39999999999999,0.42592592592592593,0.5740740740740741
653,tomssthornhill,1189,361,828,-423.40000000000066,0.3036164844407065,0.6963835155592936
654,LiamFox,536,192,344,-133.79999999999984,0.3582089552238806,0.6417910447761194
655,MarcusKravis,730,195,535,-310.00000000000006,0.2671232876712329,0.7328767123287672
656,dempsey4labour,1046,325,721,-368.6000000000004,0.3107074569789675,0.6892925430210325
657,JustinTomlinson,1210,512,698,-150.79999999999973,0.4231404958677686,0.5768595041322314
658,GFCunningham,218,98,120,-17.200000000000003,0.44954128440366975,0.5504587155963303
659,rehalfrances,416,135,281,-131.79999999999987,0.3245192307692308,0.6754807692307693
660,martinmcgann83,2020,769,1251,-437.0000000000012,0.3806930693069307,0.6193069306930693
661,AlanBeddow,4,0,4,-4.0,0.0,1.0
662,mikeobrien4mp,925,276,649,-349.8000000000002,0.2983783783783784,0.7016216216216217
663,PatMGlass,664,201,463,-245.60000000000002,0.30271084337349397,0.697289156626506
664,OwenTemple2,317,79,238,-158.40000000000003,0.24921135646687698,0.750788643533123
665,_AndyAdams_,117,37,80,-38.8,0.3162393162393162,0.6837606837606838
666,kitmalthouse,532,175,357,-158.39999999999992,0.32894736842105265,0.6710526315789473
667,ACPayton,57,20,37,-15.599999999999998,0.3508771929824561,0.6491228070175439
668,ABridgen,466,166,300,-132.0,0.3562231759656652,0.6437768240343348
669,HughinNorfolk,360,112,248,-122.19999999999995,0.3111111111111111,0.6888888888888889
670,JGray,276,81,195,-106.39999999999995,0.29347826086956524,0.7065217391304348
671,BrianMathew4NW,155,43,112,-62.60000000000001,0.27741935483870966,0.7225806451612903
672,Michael_Ellis1,920,415,505,-79.1999999999999,0.45108695652173914,0.5489130434782609
673,Sally_Keeble,1613,530,1083,-508.60000000000116,0.328580285182889,0.6714197148171109
674,angelalibdems,34,10,24,-14.0,0.29411764705882354,0.7058823529411765
675,davidmackintosh,1660,658,1002,-301.6000000000004,0.3963855421686747,0.6036144578313253
676,Jessica_Asato,708,278,430,-120.39999999999982,0.3926553672316384,0.6073446327683616
677,NorwichChloe,1719,714,1005,-258.19999999999993,0.41535776614310643,0.5846422338568935
678,JamesWrightLD,333,100,233,-127.19999999999995,0.3003003003003003,0.6996996996996997
679,_Lisa_Townsend,557,183,374,-178.19999999999993,0.32854578096947934,0.6714542190305206
680,Sim0nWright,721,296,425,-114.79999999999994,0.4105409153952843,0.5894590846047156
681,GarryKHickton,762,201,561,-316.60000000000036,0.2637795275590551,0.7362204724409449
682,LouiseBurfDons,1859,769,1090,-279.19999999999993,0.41366325981710594,0.5863367401828941
683,JaneMHunt,785,275,510,-213.7999999999999,0.3503184713375796,0.6496815286624203
684,DNewtonCook,286,80,206,-120.99999999999994,0.27972027972027974,0.7202797202797203
685,Victoria_Fowler,806,262,544,-243.39999999999964,0.3250620347394541,0.674937965260546
686,ChristinaJebb,1501,502,999,-457.4000000000009,0.3344437041972019,0.6655562958027982
687,Marcus4Nuneaton,1748,659,1089,-386.00000000000085,0.37700228832951943,0.6229977116704806
688,LukeGrahamMP,1104,429,675,-218.19999999999985,0.38858695652173914,0.6114130434782609
689,JBrokenshire,706,309,397,-71.39999999999998,0.4376770538243626,0.5623229461756374
690,OLSConservative,395,116,279,-150.79999999999993,0.2936708860759494,0.7063291139240506
691,richardmarbrow,1029,252,777,-499.0000000000003,0.24489795918367346,0.7551020408163265
692,garthharkness,1224,309,915,-586.4000000000003,0.25245098039215685,0.7475490196078431
693,DAJCameron,25,8,17,-8.2,0.32,0.68
694,acarmichael4mp,462,155,307,-150.2,0.3354978354978355,0.6645021645021645
695,McGarvey4Orkney,330,84,246,-155.19999999999993,0.2545454545454545,0.7454545454545455
696,NigeldeGruchy,2,1,1,0.0,0.5,0.5
697,JoJohnsonUK,111,35,76,-38.800000000000004,0.3153153153153153,0.6846846846846847
698,cllr_magee,1185,389,796,-361.20000000000044,0.32827004219409284,0.6717299578059072
699,alasdairjmurray,105,29,76,-41.80000000000001,0.2761904761904762,0.7238095238095238
700,nicolablackwood,1138,476,662,-159.79999999999984,0.4182776801405975,0.5817223198594025
701,SallyCopley,743,244,499,-221.5999999999999,0.3283983849259758,0.6716016150740243
702,laylamoran,1821,567,1254,-606.0000000000019,0.3113673805601318,0.6886326194398682
703,john_anders0n,140,54,86,-30.600000000000005,0.38571428571428573,0.6142857142857143
704,Douglas4Paisley,2361,42,2319,-2261.999999999999,0.017789072426937738,0.9822109275730623
705,FraserGalloway1,286,106,180,-65.80000000000003,0.3706293706293706,0.6293706293706294
706,Azhar4Pendle,1993,705,1288,-526.4000000000017,0.35373808329152034,0.6462619167084797
707,cllr_g_roach,129,34,95,-55.2,0.26356589147286824,0.7364341085271318
708,leerushworth1,995,213,782,-452.20000000000124,0.21407035175879396,0.785929648241206
709,RoryStewartUK,1263,410,853,-423.20000000000067,0.3246239113222486,0.6753760886777513
710,CllrPeterBarret,9,2,7,-4.800000000000001,0.2222222222222222,0.7777777777777778
711,LisaForbes_,2112,749,1363,-548.600000000002,0.3546401515151515,0.6453598484848485
712,alisonseabeck,95,21,74,-49.199999999999996,0.22105263157894736,0.7789473684210526
713,olivercolvile,2103,725,1378,-599.4000000000005,0.34474560152163575,0.6552543984783642
714,grahamkaimes,46,21,25,-4.6,0.45652173913043476,0.5434782608695652
715,HelenRosser4MP,34,9,25,-15.799999999999997,0.2647058823529412,0.7352941176470589
716,RobertSyms,311,109,202,-85.79999999999997,0.3504823151125402,0.6495176848874598
717,FitzMP,42,16,26,-9.6,0.38095238095238093,0.6190476190476191
718,PompeyToryParty,183,80,103,-20.599999999999998,0.4371584699453552,0.5628415300546448
719,darrensandersld,228,87,141,-52.199999999999996,0.3815789473684211,0.618421052631579
720,FlickD,835,367,468,-102.6,0.43952095808383235,0.5604790419161677
721,geraldvjuk,574,237,337,-92.59999999999998,0.41289198606271776,0.5871080139372822
722,SCrabbPembs,2101,1000,1101,-68.79999999999991,0.47596382674916704,0.524036173250833
723,Paul_Miller268,425,127,298,-149.39999999999986,0.2988235294117647,0.7011764705882353
724,CllrJoBarton,301,88,213,-117.19999999999997,0.292358803986711,0.707641196013289
725,RicHolden,733,263,470,-184.19999999999985,0.3587994542974079,0.6412005457025921
726,StuartAndrew,1594,565,1029,-433.8000000000007,0.35445420326223337,0.6455457967377666
727,RykDownes,781,162,619,-442.0000000000002,0.20742637644046094,0.7925736235595391
728,jamiehanley,1535,560,975,-370.8000000000005,0.36482084690553745,0.6351791530944625
729,sheilaboswell,1024,384,640,-226.19999999999993,0.375,0.625
730,JustineGreening,851,395,456,-63.19999999999998,0.46415981198589895,0.535840188014101
731,andy4putney,240,50,190,-129.99999999999994,0.20833333333333334,0.7916666666666666
732,MattRodda,556,207,349,-130.99999999999986,0.3723021582733813,0.6276978417266187
733,DrJennyWoods,2176,676,1500,-767.4000000000005,0.31066176470588236,0.6893382352941176
734,VictoriaGroulef,1846,744,1102,-332.6000000000001,0.40303358613217766,0.5969664138678223
735,merioconnell,62,19,43,-21.8,0.3064516129032258,0.6935483870967742
736,AlokSharma_RDG,1089,429,660,-214.00000000000014,0.3939393939393939,0.6060606060606061
737,RebeccaBlake31,3047,934,2113,-1081.599999999996,0.30653101411224154,0.6934689858877584
738,Tell_Karen,666,236,430,-185.99999999999991,0.35435435435435436,0.6456456456456456
739,orbiscat,798,298,500,-180.19999999999987,0.37343358395989973,0.6265664160401002
740,david4rv,394,126,268,-126.59999999999991,0.3197969543147208,0.6802030456852792
741,MikeHillMP,215,66,149,-76.6,0.30697674418604654,0.6930232558139535
742,robinmeltzer,1278,433,845,-375.6000000000006,0.33881064162754304,0.661189358372457
743,SachinPatel_87,271,76,195,-104.99999999999996,0.28044280442804426,0.7195571955719557
744,andykelly,36,9,27,-15.599999999999998,0.25,0.75
745,Prue4Rochester,114,21,93,-68.59999999999997,0.18421052631578946,0.8157894736842105
746,naushabahkhan,1366,426,940,-469.6000000000012,0.3118594436310395,0.6881405563689604
747,KellyTolhurst,698,310,388,-70.40000000000003,0.44412607449856734,0.5558739255014327
748,JamesDuddridge,1217,417,800,-347.20000000000067,0.34264585045193097,0.657354149548069
749,CllrIanGilbert,1395,445,950,-470.2000000000011,0.31899641577060933,0.6810035842293907
750,AndrewRosindell,365,151,214,-51.400000000000006,0.4136986301369863,0.5863013698630137
751,carolinenokes,528,211,317,-94.39999999999992,0.3996212121212121,0.6003787878787878
752,darrenpaffey,561,201,360,-142.39999999999992,0.3582887700534759,0.6417112299465241
753,ChrisConniff52,73,26,47,-18.800000000000004,0.3561643835616438,0.6438356164383562
754,charles_kennedy,501,188,313,-121.39999999999999,0.37524950099800397,0.624750499001996
755,mcc_linds,1421,516,905,-361.4000000000001,0.36312456016889516,0.6368754398311048
756,JakeBerry,2262,754,1508,-696.8000000000015,0.3333333333333333,0.6666666666666666
757,wdjstraw,596,205,391,-165.39999999999998,0.34395973154362414,0.6560402684563759
758,KevinBarronMP,51,21,30,-6.6000000000000005,0.4117647058823529,0.5882352941176471
759,Gareth4RValley,116,41,75,-31.80000000000001,0.35344827586206895,0.646551724137931
760,claire4rugby,1646,595,1051,-403.200000000001,0.3614823815309842,0.6385176184690158
761,MarkPawsey,1556,600,956,-324.60000000000053,0.3856041131105398,0.6143958868894601
762,MichaelBorio,1781,620,1161,-482.20000000000147,0.3481190342504211,0.6518809657495789
763,NickHurdUK,357,128,229,-91.79999999999995,0.3585434173669468,0.6414565826330533
764,PhilipHammondUK,369,178,191,-21.999999999999982,0.4823848238482385,0.5176151761517616
765,Aneathey,1303,442,861,-385.8000000000005,0.3392171910974674,0.6607828089025326
766,CllrDavidMellen,823,394,429,-22.400000000000002,0.4787363304981774,0.5212636695018226
767,Taylor_Muir54,468,140,328,-172.7999999999999,0.29914529914529914,0.7008547008547008
768,AlanDuncanMP,137,62,75,-11.200000000000003,0.45255474452554745,0.5474452554744526
769,RandMLibDems,1913,596,1317,-663.800000000001,0.31155253528489285,0.6884474647151072
770,SWLabour,558,158,400,-224.1999999999999,0.2831541218637993,0.7168458781362007
771,Mike4Walden,321,103,218,-105.59999999999998,0.32087227414330216,0.6791277258566978
772,RLong_Bailey,261,111,150,-32.2,0.42528735632183906,0.5747126436781609
773,reetenbanerji,507,138,369,-205.99999999999977,0.27218934911242604,0.727810650887574
774,1tomcorbin,1409,427,982,-513.8000000000012,0.3030518097941803,0.6969481902058198
775,JohnGlenUK,261,98,163,-59.80000000000003,0.37547892720306514,0.6245210727969349
776,Ian1Mcinnes,868,305,563,-241.39999999999995,0.3513824884792627,0.6486175115207373
777,jogideon,558,159,399,-227.00000000000003,0.2849462365591398,0.7150537634408602
778,stephenpglenn,989,265,724,-437.4000000000005,0.2679474216380182,0.7320525783619818
779,MPphilwilson,560,191,369,-158.1999999999998,0.3410714285714286,0.6589285714285714
780,ScottWood29,2737,805,1932,-1027.8000000000022,0.29411764705882354,0.7058823529411765
781,PaulaKeaveney,2789,868,1921,-1007.8000000000006,0.3112226604517748,0.6887773395482252
782,LangdaleCider,860,265,595,-307.60000000000014,0.3081395348837209,0.6918604651162791
783,NicolaJTurner,398,94,304,-192.99999999999997,0.23618090452261306,0.7638190954773869
784,chrisclarkcpfc,1641,561,1080,-461.60000000000133,0.34186471663619744,0.6581352833638026
785,Harry4BH,266,67,199,-124.79999999999997,0.2518796992481203,0.7481203007518797
786,PaulBlomfieldMP,1619,579,1040,-409.00000000000136,0.3576281655342804,0.6423718344657195
787,MattSleat,4,2,2,0.0,0.5,0.5
788,nick_clegg,1178,443,735,-258.5999999999999,0.3760611205432937,0.6239388794567062
789,olivercoppard,2386,737,1649,-821.6000000000001,0.3088851634534786,0.6911148365465214
790,IGWalker,176,69,107,-36.199999999999996,0.39204545454545453,0.6079545454545454
791,leoniemathers,2042,718,1324,-545.4000000000016,0.3516160626836435,0.6483839373163565
792,Mark_Spencer,1845,544,1301,-711.6000000000006,0.2948509485094851,0.7051490514905149
793,ctinker2,210,89,121,-31.600000000000005,0.4238095238095238,0.5761904761904761
794,Keith_Nevols,1664,490,1174,-634.0000000000009,0.29447115384615385,0.7055288461538461
795,malcolmbirks,401,130,271,-129.5999999999999,0.32418952618453867,0.6758104738154613
796,JulianSmithUK,1960,858,1102,-215.60000000000005,0.4377551020408163,0.5622448979591836
797,jasonforlabour,1209,430,779,-297.8000000000004,0.3556658395368073,0.6443341604631927
798,fionamacmp,1862,615,1247,-590.4000000000008,0.33029001074113856,0.6697099892588615
799,GSOnline,253,83,170,-81.20000000000002,0.32806324110671936,0.6719367588932806
800,LorelyBurt,2011,589,1422,-769.0000000000017,0.2928891098955743,0.7071108901044256
801,DJWarburton,273,89,184,-89.60000000000001,0.326007326007326,0.673992673992674
802,Alan4SAntrim,15,3,12,-7.199999999999999,0.2,0.8
803,Metcalfe_SBET,828,342,486,-139.79999999999995,0.41304347826086957,0.5869565217391305
804,geoff4mp,19,4,15,-11.2,0.21052631578947367,0.7894736842105263
805,DanGreef,648,194,454,-231.3999999999999,0.2993827160493827,0.7006172839506173
806,Seb4SouthCambs,269,65,204,-129.59999999999997,0.241635687732342,0.758364312267658
807,HeatherWheeler,856,333,523,-178.19999999999996,0.38901869158878505,0.610981308411215
808,Simon_Bowkett,1865,511,1354,-775.5999999999993,0.2739946380697051,0.7260053619302949
809,jonathanchat,550,224,326,-98.19999999999999,0.4072727272727273,0.5927272727272728
810,philhutty,971,271,700,-404.0000000000006,0.27909371781668385,0.7209062821833162
811,declanlabour,111,29,82,-50.60000000000001,0.26126126126126126,0.7387387387387387
812,sheryllmurray,1573,592,981,-375.40000000000066,0.37635092180546725,0.6236490781945327
813,GeorgeSmid,148,56,92,-33.40000000000001,0.3783783783783784,0.6216216216216216
814,AlbertoCostaMP,10,6,4,1.2,0.6,0.4
815,Hack4Labour,954,332,622,-270.2000000000003,0.3480083857442348,0.6519916142557652
816,JackyAnnH1,891,324,567,-220.99999999999997,0.36363636363636365,0.6363636363636364
817,deborahsacks,2047,643,1404,-718.8000000000009,0.31411822178798243,0.6858817782120176
818,andrealeadsom,320,139,181,-34.6,0.434375,0.565625
819,votelucymills,81,27,54,-24.200000000000003,0.3333333333333333,0.6666666666666666
820,ChesterfieldLD,243,67,176,-106.40000000000002,0.2757201646090535,0.7242798353909465
821,V_L_Bennett,1065,353,712,-333.40000000000026,0.3314553990610329,0.6685446009389672
822,SeemaKennedy,1878,629,1249,-585.6000000000014,0.3349307774227902,0.6650692225772098
823,sue_mcguire,623,194,429,-213.9999999999998,0.3113964686998395,0.6886035313001605
824,GitanjaliG,577,185,392,-191.99999999999972,0.32062391681109187,0.6793760831889082
825,robert_g_oliver,660,194,466,-252.0,0.29393939393939394,0.706060606060606
826,SStaffsLabour,48,16,32,-14.6,0.3333333333333333,0.6666666666666666
827,GavinWilliamson,379,160,219,-52.00000000000001,0.42216358839050133,0.5778364116094987
828,jc4southsuffolk,221,92,129,-32.20000000000001,0.416289592760181,0.583710407239819
829,gracelibdem,275,78,197,-111.99999999999994,0.28363636363636363,0.7163636363636363
830,DamonHooton,153,48,105,-53.79999999999999,0.3137254901960784,0.6862745098039216
831,cmackinlay,714,262,452,-179.60000000000002,0.36694677871148457,0.6330532212885154
832,willscobie,3009,1123,1886,-709.4000000000011,0.37321369225656364,0.6267863077434364
833,RussT2015Thanet,295,85,210,-119.79999999999995,0.288135593220339,0.711864406779661
834,AndrewSelous,689,259,430,-155.7999999999998,0.37590711175616837,0.6240928882438317
835,SimonLeoDiggins,557,218,339,-104.99999999999991,0.39138240574506283,0.6086175942549371
836,DavidGauke,1047,334,713,-346.0000000000007,0.31900668576886343,0.6809933142311366
837,NigelQuinton,378,112,266,-143.79999999999995,0.2962962962962963,0.7037037037037037
838,rm113,955,231,724,-466.80000000000064,0.2418848167539267,0.7581151832460733
839,trussliz,1141,473,668,-183.20000000000007,0.4145486415425066,0.5854513584574934
840,Jeremy_Hunt,1219,487,732,-218.99999999999997,0.39950779327317476,0.6004922067268252
841,HKaye_LabourPCC,2057,473,1584,-1028.0000000000014,0.22994652406417113,0.7700534759358288
842,trevorcarbin,269,36,233,-195.6,0.13382899628252787,0.8661710037174721
843,AWMurrison,1654,704,950,-204.7999999999995,0.42563482466747277,0.5743651753325272
844,Royston_Smith,1088,342,746,-366.60000000000036,0.31433823529411764,0.6856617647058824
845,Cllr_JMoulton,1612,577,1035,-425.8000000000008,0.3579404466501241,0.642059553349876
846,alanwhiteheadmp,609,171,438,-248.39999999999986,0.28078817733990147,0.7192118226600985
847,paul_m_collins,72,16,56,-38.4,0.2222222222222222,0.7777777777777778
848,johnpugh2017,592,184,408,-206.9999999999999,0.3108108108108108,0.6891891891891891
849,LizSavagelabour,1303,332,971,-590.4000000000013,0.2547966231772832,0.7452033768227168
850,SpelthorneLabPy,203,61,142,-74.20000000000002,0.30049261083743845,0.6995073891625616
851,RosieShimell,63,25,38,-12.0,0.3968253968253968,0.6031746031746031
852,sandywalkington,1328,436,892,-430.40000000000094,0.32831325301204817,0.6716867469879518
853,stevedouble,1241,445,796,-320.8000000000001,0.3585817888799355,0.6414182111200645
854,ConorMcGinn,635,312,323,-3.2000000000000144,0.49133858267716535,0.5086614173228347
855,GillianKeegan,162,59,103,-39.8,0.36419753086419754,0.6358024691358025
856,MarieRimmer,94,27,67,-33.000000000000014,0.2872340425531915,0.7127659574468085
857,CornyOlivier,103,28,75,-47.19999999999999,0.27184466019417475,0.7281553398058253
858,JeremyLefroy,1463,443,1020,-587.2000000000004,0.3028024606971975,0.6971975393028025
859,VoteMartinRiley,150,59,91,-29.999999999999986,0.3933333333333333,0.6066666666666667
860,SMcPartland,690,284,406,-113.6,0.4115942028985507,0.5884057971014492
861,susanvandeven,801,271,530,-235.79999999999984,0.3383270911360799,0.66167290886392
862,elis_wilson,249,75,174,-96.20000000000002,0.30120481927710846,0.6987951807228916
863,anncoffey_mp,492,220,272,-44.80000000000001,0.44715447154471544,0.5528455284552846
864,danhaw426,28,9,19,-7.399999999999999,0.32142857142857145,0.6785714285714286
865,cjdaniels23,163,62,101,-33.2,0.3803680981595092,0.6196319018404908
866,midroadpolitico,128,49,79,-29.799999999999997,0.3828125,0.6171875
867,Liam_ascough,2521,838,1683,-746.0000000000019,0.3324077746925823,0.6675922253074177
868,TristramHuntVA,1453,558,895,-288.8000000000002,0.38403303509979353,0.6159669649002064
869,benpolitics,1164,440,724,-260.1999999999997,0.37800687285223367,0.6219931271477663
870,RuthSmeeth,954,421,533,-93.19999999999992,0.4412997903563941,0.5587002096436059
871,RobertFlello,1341,413,928,-481.400000000001,0.307979120059657,0.692020879940343
872,BillCashMP,75,31,44,-14.399999999999999,0.41333333333333333,0.5866666666666667
873,margot_james_mp,1436,638,798,-145.99999999999991,0.44428969359331477,0.5557103064066853
874,pete4stour,2097,696,1401,-655.400000000001,0.3319027181688126,0.6680972818311874
875,JohnnyAndrews14,382,157,225,-69.19999999999999,0.4109947643979058,0.5890052356020943
876,Liz4Stratford,368,123,245,-114.39999999999995,0.3342391304347826,0.6657608695652174
877,amnajahmad,417,135,282,-133.99999999999986,0.3237410071942446,0.6762589928057554
878,KimCaddy,19,7,12,-4.6000000000000005,0.3684210526315789,0.631578947368421
879,james4suffolk,1277,389,888,-469.20000000000095,0.30462020360219266,0.6953797963978073
880,JulieElliottMP,1516,526,990,-424.2000000000006,0.3469656992084433,0.6530343007915568
881,laweenatroshi,223,78,145,-61.199999999999974,0.34977578475336324,0.6502242152466368
882,AnnMarie4SHeath,548,161,387,-212.79999999999995,0.2937956204379562,0.7062043795620438
883,RobPocock1,522,193,329,-124.39999999999992,0.36973180076628354,0.6302681992337165
884,EBrothersLabour,534,151,383,-217.39999999999992,0.28277153558052437,0.7172284644194756
885,pentreuk,106,34,72,-39.59999999999999,0.32075471698113206,0.6792452830188679
886,emmalaneblue,110,29,81,-46.800000000000004,0.2636363636363636,0.7363636363636363
887,ChrisPincher,696,249,447,-175.99999999999991,0.3577586206896552,0.6422413793103449
888,George_Osborne,1777,878,899,0.7999999999999905,0.494091164884637,0.505908835115363
889,GarethLibDem,182,49,133,-78.39999999999999,0.2692307692307692,0.7307692307692307
890,_RachelGilmour,286,87,199,-106.19999999999995,0.3041958041958042,0.6958041958041958
891,NeilGuild,688,234,454,-201.99999999999986,0.34011627906976744,0.6598837209302325
892,pow_rebecca,1488,622,866,-193.3999999999997,0.41801075268817206,0.581989247311828
893,EdwardBuxton,14,4,10,-5.800000000000001,0.2857142857142857,0.7142857142857143
894,AlistairTewkes,42,17,25,-7.6,0.40476190476190477,0.5952380952380952
895,paulcotswolds,620,184,436,-231.59999999999994,0.2967741935483871,0.7032258064516129
896,Kang4Labour,152,40,112,-69.39999999999998,0.2631578947368421,0.7368421052631579
897,trinagilman,1366,401,965,-502.8000000000017,0.2935578330893119,0.7064421669106882
898,MPritchardUK,1860,793,1067,-261.1999999999998,0.42634408602150536,0.5736559139784946
899,AveryforLabour,8,3,5,-2.0,0.375,0.625
900,kevinhollinrake,323,112,211,-94.99999999999999,0.34674922600619196,0.653250773993808
901,dinahkeal,1121,453,668,-186.39999999999972,0.4041034790365745,0.5958965209634255
902,stevewebb1,339,124,215,-82.39999999999995,0.36578171091445427,0.6342182890855457
903,JackieDP,2185,617,1568,-902.6000000000008,0.28237986270022886,0.7176201372997711
904,RhodriJB,112,30,82,-50.599999999999994,0.26785714285714285,0.7321428571428571
905,neil_parish,81,39,42,-3.1999999999999993,0.48148148148148145,0.5185185185185185
906,ClaireLeighDev,1619,615,1004,-333.80000000000086,0.37986411365040146,0.6201358863495985
907,pkfling,1849,556,1293,-695.2000000000012,0.300703082747431,0.6992969172525689
908,DanWatkins,399,142,257,-104.79999999999997,0.3558897243107769,0.6441102756892231
909,Sumaddock,1608,512,1096,-523.0000000000016,0.31840796019900497,0.681592039800995
910,adriansanders,701,188,513,-299.0000000000003,0.268188302425107,0.7318116975748931
911,Geoffrey_Cox,280,113,167,-53.20000000000001,0.4035714285714286,0.5964285714285714
912,TWDDolphin,262,59,203,-140.39999999999998,0.22519083969465647,0.7748091603053435
913,NickyjWilliams,1778,493,1285,-718.6000000000015,0.27727784026996627,0.7227221597300337
914,sarahwollaston,197,69,128,-60.20000000000001,0.350253807106599,0.649746192893401
915,Stefan4TottMP,374,100,274,-165.6,0.26737967914438504,0.732620320855615
916,tozen,2481,781,1700,-853.6000000000017,0.3147924224103184,0.6852075775896815
917,SNewtonUK,1567,595,972,-343.4000000000006,0.37970644543714105,0.620293554562859
918,TruroSimonRix,527,175,352,-154.99999999999983,0.33206831119544594,0.6679316888045541
919,GregClarkMP,410,183,227,-37.39999999999995,0.44634146341463415,0.5536585365853659
920,Kevin_Kerrigan1,280,78,202,-109.99999999999991,0.2785714285714286,0.7214285714285714
921,JamesMacCleary,848,302,546,-217.19999999999985,0.3561320754716981,0.6438679245283019
922,vincecable,949,302,647,-320.40000000000055,0.31822971548998946,0.6817702845100105
923,tania_mathias,259,120,139,-13.999999999999995,0.46332046332046334,0.5366795366795367
924,alancampbellmp,911,396,515,-100.59999999999991,0.43468715697036225,0.5653128430296378
925,JohnPD45,44,12,32,-18.6,0.2727272727272727,0.7272727272727273
926,mikefcox,541,169,372,-183.99999999999994,0.3123844731977819,0.6876155268022182
927,BorisJohnson,138,46,92,-40.20000000000001,0.3333333333333333,0.6666666666666666
928,chris4uxbridge,1925,609,1316,-633.4000000000023,0.31636363636363635,0.6836363636363636
929,JamesDavies,392,131,261,-118.59999999999994,0.33418367346938777,0.6658163265306123
930,ChrisRuane2017,552,166,386,-205.39999999999992,0.3007246376811594,0.6992753623188406
931,wgwynwilliams,19,4,15,-11.6,0.21052631578947367,0.7894736842105263
932,AlunCairns,1118,393,725,-291.2000000000006,0.35152057245080504,0.648479427549195
933,DavyPaul,1437,466,971,-472.0000000000006,0.3242867084203201,0.6757132915796799
934,KateHoeyMP,1030,463,567,-91.6,0.4495145631067961,0.5504854368932038
935,antony_calvert,507,189,318,-114.99999999999993,0.3727810650887574,0.6272189349112426
936,Kristoforbrown,1311,386,925,-490.20000000000107,0.2944317315026697,0.7055682684973302
937,DHansenLuke,2037,782,1255,-405.0000000000006,0.38389788905252825,0.6161021109474718
938,WalsallNorthLD,3,2,1,1.0,0.6666666666666666,0.3333333333333333
939,haselour,456,137,319,-165.4,0.30043859649122806,0.6995614035087719
940,joelkenrick,455,177,278,-88.19999999999997,0.389010989010989,0.610989010989011
941,Valerie_VazMP,504,178,326,-136.9999999999999,0.3531746031746032,0.6468253968253969
942,Molly4Wstow,281,88,193,-93.99999999999991,0.31316725978647686,0.6868327402135231
943,TD_Hancock,1422,309,1113,-746.8000000000008,0.21729957805907174,0.7827004219409283
944,IanLaveryMP,1331,593,738,-128.99999999999983,0.44552967693463563,0.5544703230653644
945,alexmeredithLD,547,158,389,-216.59999999999994,0.28884826325411334,0.7111517367458866
946,StephenEDWebb,199,56,143,-81.39999999999998,0.2814070351758794,0.7185929648241206
947,HelenJonesMP,636,268,368,-90.60000000000007,0.42138364779874216,0.5786163522012578
948,canazirk,396,96,300,-193.99999999999997,0.24242424242424243,0.7575757575757576
949,This_Is_Seeb,91,34,57,-19.799999999999994,0.37362637362637363,0.6263736263736264
950,lynnettekelly,1316,472,844,-348.4000000000007,0.3586626139817629,0.6413373860182371
951,Chris_WhiteUK,2087,893,1194,-252.19999999999973,0.42788691902252035,0.5721130809774796
952,BobDhillon5,1297,402,895,-455.2000000000006,0.3099460292983809,0.6900539707016191
953,libdom,1037,227,810,-555.2000000000005,0.218900675024108,0.781099324975892
954,Richard4Watford,547,182,365,-174.80000000000007,0.3327239488117002,0.6672760511882998
955,MayorDorothy,1487,562,925,-320.6000000000002,0.37794216543375925,0.6220578345662408
956,Turmaine,1469,432,1037,-560.8000000000014,0.29407760381211706,0.7059223961878829
957,peter_aldous,292,110,182,-65.79999999999997,0.3767123287671233,0.6232876712328768
958,BobJBlizzard,1401,402,999,-532.6000000000023,0.28693790149892934,0.7130620985010707
959,JuliaTickridge,1110,422,688,-233.99999999999986,0.3801801801801802,0.6198198198198198
960,PeterBoneUK,980,408,572,-147.8000000000001,0.4163265306122449,0.5836734693877551
961,votegarvie,2,1,1,-0.4,0.5,0.5
962,chris_nelson,160,52,108,-48.000000000000014,0.325,0.675
963,JSHeappey,375,153,222,-61.00000000000002,0.408,0.592
964,chrisinchley,404,133,271,-124.19999999999993,0.3292079207920792,0.6707920792079208
965,tessamunt,1847,581,1266,-623.4000000000012,0.31456415809420685,0.6854358419057932
966,Hugh_Annand,1006,269,737,-436.00000000000074,0.2673956262425447,0.7326043737574552
967,WHLabour,803,268,535,-240.39999999999992,0.33374844333748444,0.6662515566625156
968,grantshapps,2417,784,1633,-778.000000000002,0.3243690525444766,0.6756309474555233
969,JohnHealey_MP,926,349,577,-203.99999999999991,0.37688984881209503,0.6231101511879049
970,BarryBlackNE,1389,452,937,-439.800000000001,0.3254139668826494,0.6745860331173507
971,WAKLibDems,349,164,185,-20.199999999999985,0.4699140401146132,0.5300859598853869
972,oseccombe,42,17,25,-9.0,0.40476190476190477,0.5952380952380952
973,paulratner,42,11,31,-18.4,0.2619047619047619,0.7380952380952381
974,oletwinofficial,211,69,142,-71.60000000000001,0.32701421800947866,0.6729857819905213
975,fest4westham,1236,379,857,-449.8000000000006,0.30663430420711973,0.6933656957928802
976,rosie4westlancs,862,323,539,-213.39999999999998,0.37470997679814383,0.6252900232018561
977,paulvgreenall,652,199,453,-229.99999999999977,0.3052147239263804,0.6947852760736196
978,CllrDanLewis,3018,666,2352,-1596.999999999993,0.220675944333996,0.7793240556660039
979,Cllr_M_Jefferys,59,20,39,-19.599999999999998,0.3389830508474576,0.6610169491525424
980,Vote_Walton,564,155,409,-228.59999999999994,0.274822695035461,0.725177304964539
981,dawharton,1142,284,858,-559.8000000000008,0.2486865148861646,0.7513134851138353
982,kirstyrallan,796,264,532,-241.9999999999999,0.3316582914572864,0.6683417085427136
983,Lindsey4WNorth,1173,428,745,-291.6,0.3648763853367434,0.6351236146632566
984,ja_bateson,1051,336,715,-351.8000000000006,0.3196955280685062,0.6803044719314938
985,AnnMyatt2015,100,47,53,-3.400000000000003,0.47,0.53
986,JohnPeterMunro,2198,636,1562,-843.6000000000009,0.2893539581437671,0.7106460418562329
987,JohnPenroseNews,1226,495,731,-210.99999999999983,0.40375203915171287,0.5962479608482871
988,TimTaylorWeston,158,65,93,-28.20000000000001,0.41139240506329117,0.5886075949367089
989,CKConservative,506,171,335,-156.59999999999994,0.33794466403162055,0.6620553359683794
990,lisanandy,1739,670,1069,-346.2000000000009,0.3852788959171938,0.6147211040828062
991,S_Hammond,187,55,132,-75.99999999999999,0.29411764705882354,0.7058823529411765
992,Andjudge,500,180,320,-129.39999999999995,0.36,0.64
993,sbrine,1669,716,953,-212.80000000000007,0.42899940083882565,0.5710005991611744
994,jackielibdem,747,289,458,-148.1999999999998,0.3868808567603748,0.6131191432396251
995,AdamAfriyie,938,414,524,-92.59999999999991,0.44136460554371004,0.55863539445629
996,GeorgeFussey,831,287,544,-238.59999999999997,0.345367027677497,0.6546329723225031
997,elizabethjewkes,42,8,34,-23.800000000000004,0.19047619047619047,0.8095238095238095
998,David_Cameron,1697,752,945,-168.3999999999997,0.4431349440188568,0.5568650559811432
999,duncanenright,1516,446,1070,-586.2000000000011,0.2941952506596306,0.7058047493403694
1000,andyg2439,160,48,112,-63.40000000000001,0.3,0.7
1001,JonathanLord,2,1,1,-0.19999999999999996,0.5,0.5
1002,JillRawling,50,20,30,-7.599999999999998,0.4,0.6
1003,christook,2422,682,1740,-982.6000000000003,0.2815854665565648,0.7184145334434352
1004,CllrCliveJones,1234,376,858,-453.00000000000085,0.3047001620745543,0.6952998379254457
1005,johnredwood,663,161,502,-342.79999999999984,0.24283559577677225,0.7571644042232277
1006,VoteDarrenHenry,175,46,129,-77.6,0.26285714285714284,0.7371428571428571
1007,EmmaReynoldsMP,483,175,308,-116.19999999999995,0.36231884057971014,0.6376811594202898
1008,patmcfaddenmp,256,118,138,-17.400000000000002,0.4609375,0.5390625
1009,SuriaPhotay,206,63,143,-69.59999999999997,0.3058252427184466,0.6941747572815534
1010,Eleanor_SmithMP,374,88,286,-192.0,0.23529411764705882,0.7647058823529411
1011,PaulUppalWSW,690,201,489,-267.1999999999999,0.29130434782608694,0.7086956521739131
1012,neale4wsw,262,76,186,-104.6,0.2900763358778626,0.7099236641221374
1013,JoySquires,1785,733,1052,-275.7999999999999,0.4106442577030812,0.5893557422969188
1014,SueHayman1,104,44,60,-12.599999999999998,0.4230769230769231,0.5769230769230769
1015,phillroberts2,41,19,22,-1.9999999999999996,0.4634146341463415,0.5365853658536586
1016,Bikingbarrister,724,271,453,-175.2,0.3743093922651934,0.6256906077348067
1017,Mark4WyreForest,1317,420,897,-438.2000000000012,0.31890660592255127,0.6810933940774487
1018,Matt4wyreforest,513,140,373,-215.40000000000003,0.2729044834307992,0.7270955165692008
1019,johnpotterLD,1446,415,1031,-539.4000000000025,0.2869986168741355,0.7130013831258645
1020,BWallaceMP,1626,497,1129,-578.4000000000011,0.30565805658056583,0.6943419434194342
1021,Fiona20Green,581,204,377,-165.19999999999987,0.35111876075731496,0.648881239242685
1022,MikeKaneMP,887,328,559,-214.4,0.3697857948139797,0.6302142051860203
1023,MarcusFysh,68,32,36,-2.2000000000000015,0.47058823529411764,0.5294117647058824
1024,mark4ynysmon,39,9,30,-20.2,0.23076923076923078,0.7692307692307693
1025,EMichelleWillis,462,154,308,-139.7999999999999,0.3333333333333333,0.6666666666666666
1026,NickLovesYork,582,203,379,-160.19999999999996,0.3487972508591065,0.6512027491408935
1027,RobertMcIlveen,1419,501,918,-390.5999999999999,0.35306553911205074,0.6469344608879493
